name_en	name_mm
Nat Sin (No 2 Main Road)	နတ်စင် (အမှတ်(၂)လမ်းမ)
Ball Lone Kwin Htate	ဘောလုံးကွင်းထိပ်
Lay Htaut Kan Site Kwae (No 2 Road)	လေးထောင့်ကန်ဆိုက်ကွေ့ (အမှတ်(၂)လမ်း)
Gate Haung (South Dagon)	ဂိတ်ဟောင်း (တ/ဒဂုံ)
Sal Zay (TharKayTa)	၁၀ စျေး (သာကေတ)
MiBa Yate	မိဘရိပ်
Sae-hnat-lone-Tan (YanKin Road)	၁၂ လုံးတန်း (ရန်ကင်းလမ်း)
Tha Ma Sine (Lay Htaut Kan)	သမဆိုင် (လေးထောင့်ကန်)
Mote Pho (No 2 Road)	မုန့်ဖို (အမှတ်(၂)လမ်း)
Palae Ngar	ပုလဲငါး
Kyaung Shae (No 2 Road)	ကျောင်းရှေ့ (အမှတ်(၂)လမ်း)
Nyaung 2 Pin	ညောင်(၂)ပင်
Kone Padaythar (North Dagon)	ကုန်ပဒေသာ (မ/ဒဂုံ)
Ywar Thar Gyi Lai Sin Yone	ရွာသာကြီးလိုင်စင်ရုံး
Nandawun Zay	နန္ဒဝန်စျေး
U Htun Myat	ဦးထွန်းမြတ်
Sae-Hnit Thama	(၁၂) သမ
Kwin Sin Kyaung	ကွင်းဆင်းကျောင်း
Sanpya Zay (Lay Htaut Kan Road)	စံပြစျေး (လေးထောင့်ကန်လမ်း)
West Yangon Technology University	အနောက်ပိုင်းနည်းပညာတက္ကသိုလ်
Taung Myout Lan Sone (No 2 Road)	တောင်မြောက်လမ်းဆုံ (အမှတ်(၂)လမ်း)
Yuzan A Wine Htake (ShweLi Road-Dagon SateKan) Container Gate (Old Name)	ယုဇန အဝိုင်းထိပ် (ရွှေလီလမ်း - ဒဂုံဆိပ်ကမ်း) ကွန်တိန်နာဂိတ် (နာမည်ဟောင်း)
Nawaday (KaBarAye Road)	နဝဒေး (ကမ္ဘာအေးလမ်း)
Dhamar Yone (ShuKhinThar Road)	ဓမ္မာရုံ (ရှုခင်းသာလမ်း)
Container Gate (Dagon SateKan)	ကွန်တိန်နာဂိတ် (ဒဂုံဆိပ်ကမ်း)
Tayar-Chauk Tat Yin	(၁၀၆) တပ်ရင်း
Lan Wa	လမ်းဝ
Yadanar Lan Sone (Dagon SateKan)	ရတနာလမ်းဆုံ (ဒဂုံဆိပ်ကမ်း)
Thein Kyaung Lan Sone (AyarWunSanSat Road)	သိမ်ကျောင်းလမ်းဆုံ (ဧရာဝဏ်ဆက်စပ်လမ်း)
Tit Gate	(၁) ဂိတ်
Pale Kan	ပုလဲကန်
B.M Gate (South Dagon)	ဘီအမ်ဂိတ် (တ/ဒဂုံ)
Japan Lan	ဂျပန်လမ်း
Min Kun Zay	မင်းကွန်းစျေး
Htan Pin Kone	ထန်းပင်ကုန်း
Tayar-Chauk (KhaYayPin Road)	၁၀၆ (ခရေပင်လမ်း)
Tayar-Chauk (KaBarAye)	၁၀၆ (ကမ္ဘာအေး)
Zay Lay (South Dagon)	စျေးလေး (တ/ဒဂုံ)
Baho Naing Ngan Yae	ဗဟိုနိုင်ငံရေး
BawDe Yone	ဘော်ဒီရုံ
Sae-Hnit Lan	(၁၂) လမ်း
Taung Myout Lan Sone (MyohOo Pagoda)	တောင်မြောက်လမ်းဆုံ (မြို့ဦးစေတီ)
Nilar	နီလာ
SatMhu Tit Kwae	စက်မှု (၁) ကွေ့
Daewoo NarYeeSin	ဒေဝူးနာရီစင်
Lay-sae-lay (MinYeKyawSwar Road)	၄၄ (မင်းရဲကျော်စွာလမ်း)
Nwe Khwe	နွယ်ခွေ
Tit Yat Kwat	(၁) ရပ်ကွက်
Nwar Chan	နွားခြံ
Tayar-Chouk Lan Sone	(၁၀၆) လမ်းဆုံ
Tayar-Chouk Lan Sone (YM)	(၁၀၆) လမ်းဆုံ (YM)
Gate Haung	ဂိတ်ဟောင်း
Danyin Gone Lan Sone (ShwePyiThar)	ဒညင်းကုန်းလမ်းဆုံ (ရွှေပြည်သာ)
Danyin Gone Lan Sone (KhaYayPin Road)	ဒညင်းကုန်းလမ်းဆုံ (ခရေပင်လမ်း)
Sae-Lay Lan Sone	(၁၄) လမ်းဆုံ
Htan Chauk Pin	ထန်းခြောက်ပင်
Nawarat	နဝရတ်
Nawinkyar	နဝင်းကြား
Kwin Kyaung	ကွင်းကျောင်း
Thiri Mingalar Zay	သီရိမင်္ဂလာစျေး
Chan Mar Phee	ချန်မာဖီ
Sar Taik (Ahlone)	စာတိုက် (အလုံ)
Htaw Li Kwae	ထော်လီကွေ့
Thit Taw (No 2 Main Road)	သစ်တော (အမှတ်(၂)လမ်းမကြီး)
Jama Khar Nar	ဂျမခါနာ
Kyone Gyi Gate	ကျုံးကြီးဂိတ်
Sein Gyun	စိန်ဂျွန်း
Kili	ကီလီ
Maw Tin	မော်တင်
Kali	ကလီ
Sanpya	စံပြ
Latha (Latha Road)	လသာ (လသာလမ်း)
Latha (KanNar Road)	လသာ (ကမ်းနားလမ်း)
Maung Khaing	မောင်ခိုင်
Nyaung Pin Lay Zay	ညောင်ပင်လေးစျေး
Sae-ngar Lan/ Nyaung Pin Lay Zay	(၁၅) လမ်း / ညောင်ပင်လေးစျေး
Sae-ngar Lan	(၁၅) လမ်း
Chauk Htat Yone	(၆) ထပ်ရုံး
Kone Zay Tan (AhNawYaHtar)	ကုန်စျေးတန်း (အနော်ရထာ)
Lan Thone Sae	လမ်း(၃၀)
Sule (Myodaw Khan Ma)	ဆူးလေ (မြို့တော်ခန်းမ)
Yoke Shin Yone (North OakKaLar)	ရုပ်ရှင်ရုံ (မ/ဥက္ကာလာ)
Bar Road (AhNawYaHtar)	ဘားလမ်း (အနော်ရထာ)
Bokalay Zay (KoneThal Road)	ဘိုကလေးစျေး (ကုန်သည်လမ်း)
Bokalay Zay (KanNar Road)	ဘိုကလေးစျေး (ကမ်းနားလမ်း)
Pansodan (KoneThal Road)	ပန်းဆိုးတန်း (ကုန်သည်လမ်း)
Pansodan (BoGyoke Road)	ပန်းဆိုးတန်း (ဗိုလ်ချုပ်လမ်း)
Pansodan (Seikkanthar Road)	ပန်းဆိုးတန်း (ဆိပ်ကမ်းသာလမ်း)
Sule (BanDuLa Pan Chan)	ဆူးလေ (ဗန္ဓုလပန်းခြံ)
Kyel Ngar Pwint (TheinPhyu Road)	ကြယ်ငါးပွင့် (သိမ်ဖြူလမ်း)
Lan Ngar Sae (KoneThal Road)	လမ်း (၅၀) (ကုန်သည်လမ်း)
Lay-sae-chauk Road (BoGyoke Road)	၄၆ လမ်း (ဗိုလ်ချုပ်လမ်း)
Lay-sae-chauk Road (ANawYaHtar Road)	၄၆ လမ်း (အနော်ရထာလမ်း)
Seint Paul	စိန့်ပေါလ်
Si Saing (BoTaHtaung Payar Road)	ဆီဆိုင် (ဗိုလ်တစ်ထောင်ဘုရားလမ်း)
Ye Sa Khan	ရဲစခန်း
Pansodan (AhNawYaHtar)	ပန်းဆိုးတန်း (အနော်ရထာ)
Sar Taik (KyiMyintDaing)	စာတိုက် (ကြည့်မြင်တိုင်)
Baho Yone	ဗဟိုရုံး
Botahtaung Paya	ဗိုလ်တစ်ထောင်ဘုရား
Mandalay Lan	မန္တလေးလမ်း
Pansodan (BanDuLa Road)	ပန်းဆိုးတန်း (ဗန္ဓုလလမ်း)
Lay-sae-chauk Road (MaHarBanDuLa Road)	၄၆လမ်း (မဟာဗန္ဓုလလမ်း)
Theit Pan	သိပ္ပံ
Thein Phyu Zay	သိမ်ဖြူစျေး
Kyaung Lan (Lay Htaut Kan)	ကျောင်းလမ်း (လေးထောင့်ကန်)
Masalar Set (TaungNyunt)	မဆလာစက် (တောင်ညွှန့်)
Mingalar Mon Zay (SatYone Road)	မင်္ဂလာမွန်စျေး (စက်ရုံလမ်း)
Mingalar Mon Zay	မင်္ဂလာမွန်စျေး
Mingalar Zay/ Layy Lan	မင်္ဂလာစျေး/ (၄)လမ်း
Sar Taik (TheinPhyu)	စာတိုက် (သိမ်ဖြူ)
Say Yon Gyi	ဆေးရုံကြီး
Thayet Taw Kyaung	သရက်တောကျောင်း
Bogyoke Zay	ဗိုလ်ချုပ်စျေး
Sauk Lote Yae (PyiDaungSu Road)	ဆောက်လုပ်ရေး (ပြည်ထောင်စုလမ်း)
Youk Lan	ယောက်လမ်း
Bago Kalat	ပဲခူးကလပ်
Halpin	ဟယ်(လ်)ပင်
Taung Phat Moke	တောင်ဘက်မုခ်
Kyauk Taing (TharKayTa-MinNanDar)	ကျောက်တိုင် (သာကေတ မင်းနန္ဒာ)
Kyauk Taing (TharKayTa-AYarWun)	ကျောက်တိုင် (သာကေတ ဧရာဝဏ်)
Ashae Phat Moke	အရှေ့ဘက်မုခ်
Myauk Phat Moke	မြောက်ဘက်မုခ်
Bahan Thone Lan	ဗဟန်း (၃)လမ်း
Yae Khae Saing (KabarAye)	ရေခဲဆိုင် (ကမ္ဘာအေး)
Saing Thit (South Dagon)	ဆိုင်သစ် (တ/ဒဂုံ)
Nat Mauk Kyaung	နတ်မောက်ကျောင်း
Jamar (BoGyoke)	ဂျမား (ဗိုလ်ချုပ်)
Say Yone	ဆေးရုံ
Link Lan	လင့်လမ်း
Oak Lan	အုတ်လမ်း
Bandar Pin	ဗန်ဒါပင်
Shwe Gon Daing (Kabar Aye Paya)	ရွှေဂုံတိုင် (ကမ္ဘာအေးဘုရား)
Chauk Htat Kyee	(၆) ထပ်ကြီး
Ngar Htat Kyee	(၅) ထပ်ကြီး
Byaing Yae Oh Sin	ဗျိုင်းရေအိုးစင်
Home Lan	ဟုမ်းလမ်း
Thal Kwin	သဲကွင်း
Nya Zay (Upper Kyee Myin Daing Road)	ညစျေး (အထက်ကြည့်မြင်တိုင်လမ်း)
Sar Taik (PaZunDaung)	စာတိုက် (ပုဇွန်တောင်)
Koe Htat Kyee	(၉) ထပ်ကြီး
Butar (Lay Htaut Kan)	ဘူတာ (လေးထောင့်ကန်)
Kyee Myin Daing Butar	ကြည့်မြင်တိုင်ဘူတာ
Shan Lan	ရှမ်းလမ်း
Hantharwaddy Gate Haung	ဟံသာဝတီဂိတ်ဟောင်း
Mahar Myaing	မဟာမြိုင်
Myayni (Dagon SateKan)	မြေနီ (ဒဂုံဆိပ်ကမ်း)
Myaynigone (BarKaYar)	မြေနီကုန်း (ဗားကရာ)
Myayni (ThanLwin Road)	မြေနီ (သံလွင်လမ်း)
Myaynigone (Pyay Road)	မြေနီကုန်း (ပြည်လမ်း)
Shwe Man	ရွှေမန်း
Wizaya Plaza	ဝိဇယပလာဇာ
Nat Sin (MaungMaKanKanThar Road)	နတ်စင် (မောင်းမကန်ကမ်းသာလမ်း)
Nat Sin Lan (Upper KyiMyintDine)	နတ်စင်လမ်း (အထက်ကြည့်မြင်တိုင်)
Nat Sin Lan (KanNar Lan)	နတ်စင်လမ်း (ကမ်းနားလမ်း)
B.R.B	ဘီ အာ ဘီ
Hledan (KhineShweWar)	လှည်းတန်း (ခိုင်ရွှေဝါ)
Hledan	လှည်းတန်း
Hledan Zay	လှည်းတန်းစျေး
Kannar Zay	ကမ်းနားစျေး
Khaing Shwe Wah (ShuKhinThar MyohPat Road)	ခိုင်ရွှေဝါ (ရှုခင်းသာမြို့ပတ်လမ်း)
Khaing Shwe Wah (MinYeKyawSwar Road)	ခိုင်ရွှေဝါ (မင်းရဲကျော်စွာလမ်း)
Kyaung Shae (Tamwe)	ကျောင်းရှေ့ (တာမွေ)
Pyi Yeik Mon	ပြည်ရိပ်မွန်
Salin Kwin	စလင်းကွင်း
Sinmalite	ဆင်မလိုက်
Ta Kaung Road	တကောင်းလမ်း
Thinbaw Kyin (MinNanDar)	သင်္ဘောကျင်း (မင်းနန္ဒာ)
Thinbaw Kyin (YaMoneNar Road)	သင်္ဘောကျင်း (ယမုံနာလမ်း)
Yae Kyaung	ရေကြောင်း
Ye Wun	ရဲဝန်း
Kyaung Shae Dhamar Yone (KaMarYut)	ကျောင်းရှေ့ဓမ္မာရုံ (ကမာရွတ်)
Saik Pyoe Yay	စိုက်ပျိုးရေး
Har Mit Tic	ဟာမစ်တစ်
Kokkaing/ Kyaung Shae	ကုက္ကိုင်း/ ကျောင်းရှေ့
Yankin Zay	ရန်ကင်းစျေး
Awine Lay	အဝိုင်းလေး
Hmat Tan Yone	မှတ်တမ်းရုံး
Kalar Zay	ကုလားစျေး
Kyar Hmat Taing (North Dagon)	ကြားမှတ်တိုင် (မ/ဒဂုံ)
Kyar Hmat Taing (YanKin)	ကြားမှတ်တိုင် (ရန်ကင်း)
Lan Sone (South Dagon)	လမ်းဆုံ (တ/ဒဂုံ)
Lan Sone	လမ်းဆုံ
Min Lan (U Chit Maung)	မင်းလမ်း (ဦးချစ်မောင်)
Mya Lan	မြလမ်း
Zay Kwae (Gawt TaLit)	စျေးကွေ့ (ဂွတ္တလစ်)
Athin Taik (ThinGanKyun)	အသင်းတိုက် (သင်္ဃန်းကျွန်း)
Athin Taik (SatSan)	အသင်းတိုက် (စက်ဆန်း)
Kaw Set	ကော်စက်
Khap Chee Yar	ခပ်ချီးယား
Than Lan (Tamwe Lay)	သံလမ်း (တာမွေလေး)
Than Lan (Dagon SateKan)	သံလမ်း (ဒဂုံဆိပ်ကမ်း)
Zawana Gate	ဇဝနဂိတ်
Zawana (ThuMinGaLar)	ဇဝန (သုမင်္ဂလာ)
Zawana (Lay Htaut Kan)	ဇဝန (လေးထောင့်ကန်)
A.B.C	အေဘီစီ
Arthawka	အာသောက
Aung Mingalar	အောင်မင်္ဂလာ
Kyauk Myaung Zay	ကျောက်မြောင်းစျေး
Tamwe Ah Khun Lot Zay	တာမွေအခွန်လွတ်စျေး
AhthawKa (ThamainBaRan Road)	အသောက (သမိန်ဗရမ်းလမ်း)
Tamwe Plaza	တာမွေပလာဇာ
Tamwe Zay	တာမွေစျေး
Thida Oo	သီတာဦး
Nan Thida (KanNar Road)	နန်းသီတာ (ကမ်းနားလမ်း)
Yone Lay	ရုံးလေး
Zay Lay (ThanThuMar)	စျေးလေး (သံသုမာ)
Zay Lay (BaHtoo Road)	စျေးလေး (ဗထူးလမ်း)
Anawmar (AyarWun)	အနော်မာ (ဧရာဝဏ်)
Anawmar (ZinKaMar)	အနော်မာ (ဇင်ဂမာ)
Kyauk Taing (Zoo)	ကျောက်တိုင် (တိရိစ္ဆာန်ဥယျာဉ်)
Kyauk Taw Gyee	ကျောက်တော်ကြီး
Myayni (MinNanDar Road)	မြေနီ (မင်းနန္ဒာလမ်း)
Myayni Lan Kwae	မြေနီလမ်းကွေ့
Tat Phwet (MinNanDar Road)	တပ်ဖွဲ့ (မင်းနန္ဒာလမ်း)
Bokalay Zay (MaHarBanDuLa Road)	ဘိုကလေးစျေး (မဟာဗန္ဓုလလမ်း)
Botahtaung Zay	ဗိုလ်တစ်ထောင်စျေး
Gandee (AhNawYaHtar)	ဂန္ဒီ (အနော်ရထာ)
Gandee (MaHarBanDuLa Road)	ဂန္ဒီ (မဟာဗန္ဓုလလမ်း)
Gandee Say Yone (KoneThal Road)	ဂန္ဒီဆေးရုံ (ကုန်သည်လမ်း)
Lin Sadaung	လင်းစဒေါင်း
Thida Road	သီတာလမ်း
Thida Seik (Lower PaZunDaung Road)	သီတာဆိပ် (အောက်ပုဇွန်ထောင်လမ်း)
Dhamar Yone (North OakKaLar)	ဓမ္မာရုံ (မ/ဥက္ကာလာ)
Gate Haung (Dhamar Yone) Lal Yar	ဂိတ်ဟောင်း(ဓမ္မာရုံ) လယ်ယာ
Man Pyae (YaMoneNar Road)	မာန်ပြေ (ယမုံနာလမ်း)
Shukhinthar	ရှုခင်းသာ
Thone Gate Haung (MyinThawThar Road)	၃ဂိတ်ဟောင်း (မြင်တော်သာလမ်း)
Koe Lan	(၉) လမ်း
Mingalar Zay (BaNyar DaLa Road)	မင်္ဂလာစျေး (ဗညားဒလလမ်း)
Nyaung Tan	ညောင်တန်း
Pazundaung Zay	ပုဇွန်တောင်စျေး
Warso	ဝါဆို
Yuzana Plaza	ယုဇနပလာဇာ
Yuzana CityMart Gate Yin	ယုဇနစီးတီးမတ်ဂိတ်ရင်း
Nal Myay Yon (MyinThawThar Road)	နယ်မြေရုံး (မြင်တော်သာလမ်း)
Ashae Kyar	အရှေ့ကြား
Khin Ma Ma Kyar	ခင်မမကြား
Si Saing (ShweLi)	ဆီဆိုင် (ရွှေလီ)
Si Saing Kwae	ဆီဆိုင်ကွေ့
Thadar Yon	သဒ္ဒါရုံ
Thinbaw Kyin (Dagon SateKan)	သင်္ဘောကျင်း (ဒဂုံဆိပ်ကမ်း)
Thinbaw Kyin (BaYintNaung Road)	သင်္ဘောကျင်း (ဘုရင့်နောင်လမ်း)
Wet Su (MinNanDar)	ဝက်စု (မင်းနန္ဒာ)
Yan Aung	ရန်အောင်
Yan Pyay (MyinThawThar Road)	ရန်ပြေ (မြင်တော်သာလမ်း)
Khan Ma	ခန်းမ
Kyel Ngar Pwint (AungThuKha)	ကြယ်ငါးပွင့် (အောင်သုခ)
Kyel Ngar Pwint (No 6 Road)	ကြယ်ငါးပွင့် (အမှတ်(၆)လမ်း)
Lay-sae-koe Gate Haung (Yadanar Road) TineYinThar Village	(၄၉) ဂိတ်ဟောင်း (ရတနာလမ်း) တိုင်းရင်းသားကျေးရွာ
Lay-sae-koe Asane Gate Haung (ShuKhinThar MyohPat Road)	၄၉ အစိမ်းဂိတ်ဟောင်း (ရှုခင်းသာ မြို့ပတ်လမ်း)
Mee Thwe Saing	မီးသွေးဆိုင်
Ngar Kwae	(၅) ကွေ့
Dat Si Saing (TharKayTa)	ဓာတ်ဆီဆိုင် (သာကေတ)
Si Saing (TharKayTa)	ဆီဆိုင် (သာကေတ)
Waizayantar (Khun Zay)	ဝေဇယန္တာ (၇စျေး)
Waizayantar (ShuKhinThar EainYar)	ဝေဇယန္တာ (ရှုခင်းသာအိမ်ယာ)
Yoke Shin Yone (MyinThawTar Road)	ရုပ်ရှင်ရုံ (မြင်တော်သာလမ်း)
Yoke Shin Yone (ZinGaMar)	ရုပ်ရှင်ရုံ (ဇင်ဂမာ)
ThanMaTa Yoke Shin Yone (Yout Road)	သမ္မတရုပ်ရှင်ရုံ (ယောက်လမ်း)
Yoke Shin Yone AHaung	ရုပ်ရှင်ရုံ အဟောင်း
Sae-Thone Gate	(၁၃) ဂိတ်
Gate Wa (TharKayTa)	ဂိတ်ဝ (သာကေတ)
Lat Hmat Gate	လက်မှတ်ဂိတ်
Khun Zay (MyinThawThar Road)	၇စျေး (မြင်တော်သာလမ်း)
Kyan Mar Yae (North Dagon)	ကျန်းမာရေး (မ/ဒဂုံ)
Kyan Mar Yae (South Dagon)	ကျန်းမာရေး (တ/ဒဂုံ)
Kyaung Kwae (North Dagon)	ကျောင်းကွေ့ (မ/ဒဂုံ)
Kyaung Kwae (AyarWun)	ကျောင်းကွေ့ (ဧရာဝဏ်)
Htuu Par Yone (ZinGaMar)	ထူပါရုံ (ဇင်ဂမာ)
Myayni (Ayar Wun)	မြေနီ (ဧရာဝဏ်)
Paya Shae (MyinThawTar Road)	ဘုရားရှေ့ (မြင်တော်သာလမ်း)
Kyaik Khouk Paya Shae	ကျိုက်ခေါက်ဘုရားရှေ့
Shit Gate	၈ ဂိတ်
Tit Zay Kwae (MinNanDar Road)	၁ စျေးကွေ့ (မင်းနန္ဒာလမ်း)
Awine (DU)	အဝိုင်း (DU)
Awine	အဝိုင်း
Thama College	သမကောလိပ်
Lelyar Gate Yinn	လယ်ယာ (ဂိတ်ရင်း)
Sauk Lote Yae (WYTU)	ဆောက်လုပ်ရေး (WYTU)
Sauk Lote Yae (Thanlyin ChinKat Road)	ဆောက်လုပ်ရေး (သန်လျင်ချဉ်းကပ်လမ်း)
Sauk Lote Yae (Kamar Kyi Road)	ဆောက်လုပ်ရေး (ကမာကြည်လမ်း)
Sauk Lote Yae (Yangon-Pathein)	ဆောက်လုပ်ရေး (ရန်ကုန်-ပုသိမ်)
Sauk Lote Yae (YBS 82)	ဆောက်လုပ်ရေး (YBS 82)
Sauk Lote Yae (Myaung Ta Kar)	ဆောက်လုပ်ရေး (မြောင်းတကာ)
Tadar Htate (South Dagon)	တံတားထိပ် (တ/ဒဂုံ)
Tadar Htate (TaPinShweHtee Road)	တံတားထိပ် (တပင်ရွှေထီးလမ်း)
Tayar-Shit Taung PaYar	၁၀၈ တောင်ဘုရား
Thaketa Awine (AyarWun)	သာကေတအဝိုင်း (ဧရာဝဏ်)
Asean	အာဆီယံ
Than Lan (Baho Road)	သံလမ်း (ဗဟိုလမ်း)
Than Lan (YanKin)	သံလမ်း (ရန်ကင်း)
Kyaung Lan (Hlaw Kar Road)	ကျောင်းလမ်း (လှော်ကားလမ်း)
Kyaung Lan (KyanSitThar Road)	ကျောင်းလမ်း (ကျန်စစ်သားလမ်း)
Paw San Hmwe	ပေါ်ဆန်းမွှေး
Su Paung	စုပေါင်း
Thuwunna Lan Sone (Waizayanar)	သုဝဏ္ဏလမ်းဆုံ (ဝေဇယန္တာ)
Aung Zay Ya	အောင်ဇေယျ
Bayint Naung	ဘုရင့်နောင်
Dote Hta WaDi	ဒုဋ္ဌဝတီ
Mee Don	မီးဒုံး
Min Din	မင်းဒင်
Ta Yar Yone	တရားရုံး
Thuwunna Zay	သုဝဏ္ဏစျေး
Daywadaha	ဒေဝဒဟ
Ar Nandar Paya	အာနန္ဒာဘုရား
Bawa Myint (ThinganKyun)	ဘဝမြင့် (သင်္ဃန်းကျွန်း)
Bawa Myint (Yadanar Road)	ဘဝမြင့် (ရတနာလမ်း)
B.O.C (ThinganKyun)	ဘီအိုစီ (သင်္ဃန်းကျွန်း)
B.O.C (HlaingTharYar)	ဘီအိုစီ (လှိုင်သာယာ)
Gate Haung	ဂိတ်ဟောင်း
Kalar Su	ကုလားစု
Kyaikkasan Lan Sone	ကျိုက္ကဆံလမ်းဆုံ
Lai Sin Yone (ThanThuMar Road)	လိုင်စင်ရုံး (သံသုမာလမ်း)
Lai Sin Yone (Yadanar Road)	လိုင်စင်ရုံး (ရတနာလမ်း)
Paya Lan (ThinganKyun)	ဘုရားလမ်း (သင်္ဃန်းကျွန်း)
Paya Lan (HlaingTharYar)	ဘုရားလမ်း (လှိုင်သာယာ)
Chan Aye Thwar Say	ချမ်းအေးသွားဆေး
Kar Gyi Gate (Nga Moe Yeik)	ကားကြီးဂိတ် (ငမိုးရိပ်)
Kar Gyi Gate (Hlaw Kar Road)	ကားကြီးဂိတ် (လှော်ကားလမ်း)
Sanpya Zay (ThuWaNa)	စံပြစျေး (သုဝဏ္ဏ)
Sanpya Zay Kwae	စံပြစျေးကွေ့
Waibula	ဝေဘူလ
Alo Taw Pyae (Yadanar Road)	အလိုတော်ပြည့် (ရတနာလမ်း)
Sauk Lote Yae (Pyay Road)	ဆောက်လုပ်ရေး (ပြည်လမ်း)
Sauk Lote Yae (AyarWunSanSat Road)	ဆောက်လုပ်ရေး (ဧရာဝဏ်ဆက်စပ်လမ်း)
Thit Sait	သစ်ဆိပ်
Set Hmu Zone Hnit (South Dagon)	စက်မှုဇုန် ၂ (တ/ဒဂုံ)
Thit Saing Kwae (SiiPin Road)	သစ်ဆိုင်ကွေ့ (စည်ပင်လမ်း)
Chauk-sae-ngar 	၆၅
Kyar Kan	ကြာကန်
Shwe Taung Kyar Lan	ရွှေတောင်ကြားလမ်း
Sittaung	စစ်တောင်း
Thein Kyaung	သိမ်ကျောင်း
Thitsar	သစ္စာ
Tadar Phyu (No 2 Main Road)	တံတားဖြူ (အမှတ်(၂)လမ်းမကြီး)
Tadar Phyu (HlaingTharYar)	တံတားဖြူ (လှိုင်သာယာ)
Taung Myauk Lan Sone	တောင်/မြောက်လမ်းဆုံ
Than Lan (AungZayYa Road)	သံလမ်း (အောင်ဇေယျလမ်း)
Than Lan (Insein)	သံလမ်း (အင်းစိန်)
Gate Haung	ဂိတ်ဟောင်း
Kone Padaythar (South Dagon)	ကုန်ပဒေသာ (တောင်ဒဂုံ)
Kone Padaythar (TaPinShweHtee)	ကုန်ပဒေသာ (တပင်ရွှေထီး)
Pan Chan (South Dagon)	ပန်းခြံ (တောင်ဒဂုံ)
Yauk Kaw	ယောက်ကော်
Hnit-sae Zay	(၂၀) စျေး
Hnit-sae Shit Ta Dar Htate	၂၈တံတားထိပ်
Kar Lay Gate (South Dagon)	ကားလေးဂိတ် (တ/ဒဂုံ)
Nha-Sal Kone Taik	၂၀ ကုန်တိုက်
Kone Taik	ကုန်တိုက်
Thapyay Nyo	သပြေညို
Kyan Mar Yae (PyiDaungSu Road)	ကျန်းမာရေး (ပြည်ထောင်စုလမ်း)
Kyan Mar Yae (HlaingTharYar)	ကျန်းမာရေး (လှိုင်သာယာ)
Ngar-sae Lay Tha Ma	(၅၄) သမ
Phone Gyi Kyaung Kwae	ဘုန်းကြီးကျောင်းကွေ့
Phone Gyi Kyaung Kwae (MaungMaKanKanThar Road)	ဘုန်းကြီးကျောင်းကွေ့ (မောင်းမကန်ကမ်းသာလမ်း)
Sae-shit Kwae (MaungMaKanKanThar Road)	၁၈ ကွေ့ (မောင်းမကန်ကမ်းသာလမ်း)
Sae-shit Kwae (SiiPin Road)	၁၈ ကွေ့ (စည်ပင်လမ်း)
Tadar Htate (PyiDaungSu Road)	တံတားထိပ် (ပြည်ထောင်စုလမ်း)
Awaiyar	အဝေရာ
Kun Yar Saing (South Dagon)	ကွမ်းယာဆိုင် (တောင်ဒဂုံ)
Kun Yar Saing (HlawKar)	ကွမ်းယာဆိုင် (လှော်ကား)
Ngar-sae-chauk Lan Sone	(၅၆) လမ်းဆုံ
Khun-Hnit-Sal/ Khun-Hnit-Sae Tit Zay (KyanSitThar Road)	၇၀/၇၁ စျေး (ကျန်စစ်သားလမ်း)
Ah Kyaw Tae (South Dagon)	အကြော်တဲ (တ/ဒဂုံ)
Ah Kyaw Tae (MaHarMyaing)	အကြော်တဲ (မဟာမြိုင်)
Kar Gyi Gate (Thar Kay Ta)	ကားကြီးဂိတ် (သာကေတ)
Kar Gyi Gate (Wai Bar Gi)	ကားကြီးဂိတ် (ဝေဘာဂီ)
Kyauk Lan (No 2 Main Road)	ကျောက်လမ်း (အမှတ်(၂)လမ်းမကြီး)
Kyauk Lan (Dagon SateKan)	ကျောက်လမ်း (ဒဂုံဆိပ်ကမ်း)
Say Yon Shae	ဆေးရုံရှေ့
U Tun Myat	ဦးထွန်းမြတ်
War Saing Kwae	ဝါးဆိုင်ကွေ့
Yone Shae (South Dagon)-PyiDaungSu Road	ရုံးရှေ့ (တောင်ဒဂုံ)-ပြည်ထောင်စုလမ်း
Yone Shae (North Dagon)	ရုံးရှေ့ (မ/ဒဂုံ)
Mya Nandar	မြနန္ဒာ
Yadanar Lan	ရတနာလမ်း
Oh Eain (BoGyoke Road)	အိုးအိမ် (ဗိုလ်ချုပ်လမ်း)
Oh Eain (No 3 Main Road)	အိုးအိမ် (အမှတ် (၃) လမ်းမကြီး)
Moke Oo (Yuzana Garden)	မုခ်ဦး (ယုဇနဥယျာဉ်)
Padauk Kwae (Kyun ShweWar Road)	ပိတောက်ကွေ့ (ကျွန်းရွှေဝါလမ်း)
Padauk Kwae (PoneNarMe Road)	ပိတောက်ကွေ့ (ပုဏ္ဍမီလမ်း)
Sae-Tit Lan (Yuzana)	၁၁ လမ်း (ယုဇန)
Nwe Thar Gi	နွယ်သာဂီ
May Dar Wi Lan Sone	မေဓာဝီလမ်းဆုံ
Mya Yadanar (North OakKaLar)	မြရတနာ (မ/ဥက္ကာလာ)
Oakkar	ဥက္ကာ
Yoke Shin Yone (Bago Road)	ရုပ်ရှင်ရုံ (ပဲခူးလမ်း)
Yone	ရုံး
Dhamar Yone (Shwe Pauk Kan)	ဓမ္မာရုံ (ရွှေပေါက်က္ကံ)
Sae-Ngar Dhamar Yone	၁၅ ဓမ္မာရုံ
Aung Mingalar A Way Pyay (Entrance)	အောင်မင်္ဂလာအဝေးပြေး (ဝင်ပေါက်)
Aung Mingalar A Way Pyay (Pa Wun Htake)	အောင်မင်္ဂလာအဝေးပြေး (ပ) ဝန်းထိပ်
Tat Htate	တပ်ထိပ်
Chauk Kwae (North OakKaLar)	၆ကွေ့ (မြောက်ဥက္ကာလာ)
Chauk Kwae (Wai Bar Ge)	၆ကွေ့ (ဝေဘာဂီ)
Kar Gyi Gate (Thone Khwa)	ကားကြီးဂိတ် (သုံးခွ)
Kar Gyi Gate (Thanlyin)	ကားကြီးဂိတ် (သန်လျင်)
Kar Gyi Gate (Shwe Pyi Thar)	ကားကြီးဂိတ် (ရွှေပြည်သာ)
Kyaung Lan (Wai Bargi Road)	ကျောင်းလမ်း (ဝေဘာဂီလမ်း)
Kyaung Lan (ThanLwin Road)	ကျောင်းလမ်း (သံလွင်လမ်း)
Sae-Khun Gate	၁၇ဂိတ်
Maw Kyun	မော်ကျွန်း
Mee Thet	မီးသတ်
Min Htoo Kyaw	မင်းထူးကျော်
Sal Myaung (Bago Road)	ဆည်မြောင်း (ပဲခူးလမ်း)
Sal Myaung (East Dagon)	ဆည်မြောင်း (ရှေ့ဒဂုံ)
Say Yon Kwae (Dagon SateKan)	ဆေးရုံကွေ့ (ဒဂုံဆိပ်ကမ်း)
Eindar	က္ကန္ဒာ
Gate Haung Kwae	ဂိတ်ဟောင်းကွေ.
Kan Tharyar (North OakKaLar)	ကန်သာယာ (မြောက်ဥက္ကာလာ)
Kan Tharyar (ShwePyiThar)	ကန်သာယာ (ရွှေပြည်သာ)
Kyaung Lan (North Dagon)	ကျောင်းလမ်း (မ/ဒဂုံ)
Kyaung Lan (University Avenue Road)	ကျောင်းလမ်း (တက္ကသိုလ်ရိပ်သာလမ်း)
Kyoe Tadar	ကြိုးတံတား
Myittar	မေတ္တာ
Ou Zanar	ဥဇ္ဇနာ
Sabei	စံပယ်
Thandar	သန္တာ
Thu Nandar	သုနန္ဒာ
Waziyar	ဝဇီယာ
Za-myin-zwe Zay	(စျ) စျေး
Duyar Lan	ဒူးယားလမ်း
Dawei Chaun	ထားဝယ်ချောင်
Kyan Mar Yae (TharKayTa)	ကျန်းမာရေး (သာကေတ)
Kyan Mar Yae (YarZaThinGyan)	ကျန်းမာရေး (ရာဇသင်္ကြန်)
YarZaDaRitz Ngar-sae Kwae	ရာဇဓိရာဇ် (၅၀)ကွေ့
Yone Shae (North OakKalar)	ရုံးရှေ့ (မ/ဥက္ကာလာ)
Yone Shae (HlaingTharYar)	ရုံးရှေ့ (လှိုင်သာယာ)
Ga-gyi Zay	(ဃ) စျေး
Gate Haung	ဂိတ်ဟောင်း
Kyauk Yae Twin	ကျောက်ရေတွင်း
Myauk Okkalar Awine	မြောက်ဥက္ကလာအဝိုင်း
Phone Gyi Lan (North OakKaLar)	ဘုန်းကြီးလမ်း (မြောက်ဥက္ကလာ)
Phone Gyi Lan (AhTharWaTi Road)	ဘုန်းကြီးလမ်း (အာသာဝတီလမ်း)
Yone Thit (North OakKaLar)	ရုံးသစ် (မ/ဥက္ကာလာ)
Gandar Yone (North Dagon)	ဂန္ဓာရုံ (မ/ဒဂုံ)
Khay Mar	ခေမာ
Gate Haung (KhayMarThi)	ဂိတ်ဟောင်း (ခေမာသီ)
AWineHtake (North OakKalar)(KhayMarThi)	အဝိုင်းထိပ် (မ/ဥက္ကာလာ) (ခေမာသီ)
Kyaung Kwae (MyinThawThar Road)	ကျောင်းကွေ့ (မြင်တော်သာလမ်း)
Phyo Sabei	ဖြိုးစံပယ်
Ba Htoo Zay	ဗထူးစျေး
Banyardala	ဗညားဒလ
Kyan Mar Yae	ကျန်းမာရေး
Kyaung Lay Shae (North Dagon)	ကျောင်းလေးရှေ့ (မ/ဒဂုံ)
Lay-sae-lay(North Dagon)	၄၄ (မ/ဒဂုံ)
Khun/ Shit Lan Sone (PyiDaungSu Road)	၇/၈ လမ်းဆုံ (ပြည်ထောင်စုလမ်း)
Lay-sae-nga (North Dagon)	၄၅ (မ/ဒဂုံ)
Bo Min Gaung	ဗိုလ်မင်းခေါင်
Kyaung Lan (Shwe Pout Kan)	ကျောင်းလမ်း (ရွှေပေါက်ကံ)
Thone-sae-chauk Gate Haung	(၃၆) ဂိတ်ဟောင်း
Sae-Hnit Gate	(၁၂) ဂိတ်
Phone Gyi Lan	ဘုန်းကြီးလမ်း
Sadon Duu War	ဆဒုံဒူးဝါး
Nar Yee Sin (North Dagon)	နာရီစင် (မ/ဒဂုံ)
Nar Yee Sin	နာရီစင်
Ah Kyaw Tae (No 2 Road)	အကြော်တဲ (အမှတ်(၂) လမ်း)
Chauk Lan	(၆) လမ်း
Hong Kong	ဟောင်ကောင်
Thin Win	သင်းဝင်
Thone-sae-ngar Kwae	(၃၅) ကွေ့
Kyaung Lan (Hlaing TharYar)	ကျောင်းလမ်း (လှိုင်သာယာ)
Kyaung Lan (Ar Thar Wadi Road)	ကျောင်းလမ်း (အာသာဝတီလမ်း)
Settwe Yae (ShweDaGon PaYar Road)	ဆက်သွယ်ရေး (ရွှေတိဂုံဘုရားလမ်း)
Settwe Yae (North Dagon)	ဆက်သွယ်ရေး (မ/ဒဂုံ)
Sittaung Lan	စစ်တောင်းလမ်း
Swan In (North Dagon)	စွမ်းအင် (မ/ဒဂုံ)
Kasar Kwin	ကစားကွင်း
Ka Pa Ya	ကပရ
Ma Wa Ta Sone (PyiDaungSu Road)	မဝတလမ်းဆုံး (ပြည်ထောင်စုလမ်း)
Tadar Htate (Myeik)	တံတားထိပ် (မြိတ်)
Lay Kyaung	လေကျောင်း
Tat Yin Thone (No 2 Main Road)	တပ်ရင်း (၃) (အမှတ်(၂)လမ်းမ)
Thin Tan Kyaung	သင်တန်းကျောင်း
A Aye Saing	အအေးဆိုင်
Lay-sae-chauk Lan Sone (North Dagon)	၄၆ လမ်းဆုံ (မ/ဒဂုံ)
Lay-sae-chauk Road	၄၆ လမ်း
Lay-sae-chauk Lan Sone (BaHtoo Road)	၄၆ လမ်းဆုံ (ဗထူးလမ်း)
Myawaddy	မြဝတီ
Sein Pan	စိန်ပန်း
Zay Lay (HlaingTharYar)	စျေးလေး (လှိုင်သာယာ)
Zay Lay (KyanSitThar Road-HlaingTharYar)	စျေးလေး (ကျန်စစ်သားလမ်း-လှိုင်သာယာ)
Dagon University	ဒဂုံတက္ကသိုလ်
Moke Oo (YuZaNa)	မုခ်ဦး (ယုဇန)
West Moke Oo (ShweLi Road)	အနောက်မုခ်ဦး (ရွှေလီလမ်း)
Moke Oo (DU)	မုခ်ဦး (DU)
Moke Oo (DU - MinYeKyawSwar Road)	မုခ်ဦး (DU) - မင်းရဲကျော်စွာလမ်း
Yone Shae (South Dagon)	ရုံးရှေ့ (တ/ဒဂုံ)
Si Pin	စည်ပင်
Baho Zay (Thitsar Lan)	ဗဟိုစျေး (သစ္စာလမ်း)
Kyauk Kone	ကျောက်ကုန်း
Kyauk Kone Htate	ကျောက်ကုန်းထိပ်
Moe Kaung	မိုးကောင်း
Zay Than Lan (HlawKar)	စျေးသံလမ်း (လှော်ကား)
Than Lan (ShwePyiThar)	သံလမ်း (ရွှေပြည်သာ)
Parami Than Lan	ပါရမီသံလမ်း
Sar Taik (Yankin)	စာတိုက် (ရန်ကင်း)
Aung Yadanar SayKhan	အောင်ရတနာဆေးခန်း
Kalar Paya (Mingalardon)	ကုလားဘုရား (မင်္ဂလာဒုံ)
Kalar Paya (Yadanar Road)	ကုလားဘုရား (ရတနာလမ်း)
Ponnami (South OakKaLar)	ပုဏ္ဏမီ (တောင်ဥက္ကလာ)
Sar Taik (TharKayTa)	စာတိုက် (သာကေတ)
Sar Taik (ThitSar Road)	စာတိုက် (သစ္စာလမ်း)
Yadanar Zay	ရတနာစျေး
Yone Shae (South OakKaLar)	ရုံးရှေ့ (တောင်ဥက္ကလာ)
Bay Li (ThanThuMar Road)	ဘေလီ (သံသုမာလမ်း)
Inwa EainYar 	အင်းဝအိမ်ယာ
Inwa EainYar (Myeik Road)	အင်းဝအိမ်ယာ (မြိတ်လမ်း)
Myin Thar Zay	မြင်သာစျေး
Paya Lan (Insein Road)	ဘုရားလမ်း (အင်းစိန်လမ်း)
Pinya	ပင်းယ
OkKaLarPa Paya (ThanThuMar)	ဥက္ကလာပဘုရား (သံသုမာ)
Se Man Kane	စီမံကိန်း
Kyaung Lan (Ta Pin Shwe Htee)	ကျောင်းလမ်း (တပင်ရွှေထီး)
Kyaung Lan (Min Ye Kyaw Swar)	ကျောင်းလမ်း (မင်းရဲကျော်စွာ)
Yoe Lay	ရိုးလေး
Mile Hnat-sae	မိုင် (၂၀)
Bago Lan	ပဲခူးလမ်း
Shwe Yin Aye Paya	ရွှေရင်အေးဘုရား
Site Kar Gate	ဆိုက်ကားဂိတ်
Site Kar Gate (Nyaung Kone)	ဆိုက်ကားဂိတ် (ညောင်ကုန်း)
Zay Lay (ShweLinPan)	စျေးလေး (ရွှေလင်ပန်း)
Ah Htoo Gate	အထူးဂိတ်
Ah Hta Ka Thone	အထက (၃)
Shwe Myin Pyan	ရွှေမြင်းပျံ
Yin Htun	ရင်ထွန်း
Koe-Sae-Chauk Gate Haung	(၉၆) ဂိတ်ဟောင်း
Shwe Thee Lay	ရွှေသီးလေး
B.O.C (NatMout Road)	ဘီအိုစီ (နတ်မောက်လမ်း)
B.O.C (MingalarDone)	ဘီအိုစီ (မင်္ဂလာဒုံ)
Sanay Ma	စနေမ
Ngar-Htake Sanay Ma	(၅) ထိပ် (စနေမ)
Thama Kone (HlaingTharYar)	သမကုန်း (လှိုင်သာယာ)
Thama Kone (AhNawYaHtar Road)	သမကုန်း (အနော်ရထာလမ်း)
Chauk Tha Ma	(၆) သမ
Mee Khwat Zay	မီးခွက်စျေး
Mee Khwat Zay Lower Htate	မီးခွက်စျေးအောက်ထိပ်
Mee Khwat Zay (KhaYan)	မီးခွက်စျေး (ခရမ်း)
Sauk Lote Yae (No 4 Road)	ဆောက်လုပ်ရေး (အမှတ်(၄)လမ်း)
Sauk Lote Yae (Yadanar Road-TharKayTa)	ဆောက်လုပ်ရေး (ရတနာလမ်း - သာကေတ)
Ngar Gate	(၅) ဂိတ်
Ngar Htate	(၅) ထိပ်
Thone Htate	(၃) ထိပ်
Paya Lan (Shwe LinBan)	ဘုရားလမ်း (ရွှေလင်ဗန်း)
Paya Lan (ThitSar Road)	ဘုရားလမ်း (သစ္စာလမ်း)
Ah Sint Myint	အဆင့်မြင့်
Bogyoke	ဗိုလ်ချုပ်
Set Hmu Zone (HlaingTharYar)	စက်မှုဇုန် (လှိုင်သာယာ)
Set Hmu Zone (DarPain)	စက်မှုဇုန် (ဒါးပိန်)
Butar (Kyee Myint Daing)	ဘူတာ (ကြည့်မြင်တိုင်)
Chaung Wa	ချောင်းဝ
O One	အိုဝမ်း
Padauk Chaung/Thiri Mingalar Zay Thit	ပိတောက်ချောင်း/သီရိမင်္ဂလာစျေးသစ်
Kamayut Station (Baho Road)	ကမာရွတ်ဘူတာ (ဗဟိုလမ်း)
Kamayut Station Lan (Baho Road)	ကမာရွတ်ဘူတာရုံလမ်း (ဗဟိုလမ်း)
San Yeik Nyein	စံရိပ်ငြိမ်
Sin Yae Twin	ဆင်ရေတွင်း
ThuKhuMa	သုခုမ
Thukha	သုခ
Ywarma Kwae (Baho Road)	ရွာမကွေ့ (ဗဟိုလမ်း)
Ywarma Kwae (BaYintNaung Road)	ရွာမကွေ့ (ဘုရင့်နောင်လမ်း)
Marlar Myaing (5/6)	မာလာမြိုင် (၅/၆)
Marlar	မာလာ
Tadar Phyu (Bo Min Yaung)	တံတားဖြူ (ဗိုလ်မင်းရောင်)
Tadar Phyu (Shwe Pouk Kan)	တံတားဖြူ (ရွှေပေါက်ကံ)
Bayint Naung Lan Sone	ဘုရင့်နောင်လမ်းဆုံ
Buya	ဘုရ
Oakyin (Baho Road)	အုတ်ကျင်း (ဗဟိုလမ်း)
Oakyin (BaYintNaung Road)	အုတ်ကျင်း (ဘုရင့်နောင်လမ်း)
Sit Kyawe Yae/ Shaw Yawe	စစ်ကြောရေး/ လျှော်ရွေး
Thamine Myoh Thit (Baho Road)	သမိုင်းမြို့သစ် (ဗဟိုလမ်း)
Thiri Myaing	သီရိမြိုင်
Zay Butar	စျေးဘူတာ
Bartar	ဘာတာ
Kyway Tit	ကြွေတစ်
Oakyin (Insein Road)	အုတ်ကျင်း (အင်းစိန်လမ်း)
Paya Lan (Pathein Road)	ဘုရားလမ်း (ပုသိမ်လမ်း)
U Ba Han	ဦးဘဟန်
A.D	အေဒီ
Khun-nha Mile	(၇) မိုင်
Kyaung Kwae (BoMinYaung)	ကျောင်းကွေ့ (ဗိုလ်မင်းရောင်)
Chaw Twin Kone (KaBarAye)	ချော်တွင်းကုန်း (ကမ္ဘာအေး)
Chaw Twin Kone (KaBarAye PaYar Road)	ချော်တွင်းကုန်း (ကမ္ဘာအေးဘုရားလမ်း)
Kabar Aye Paya	ကမ္ဘာအေးဘုရား
Yeik Thar (Lay Htaut Kan)	ရိပ်သာ (လေးထောင့်ကန်)
Yeik Thar (No 2 Road)	ရိပ်သာ (အမှတ်(၂)လမ်း)
Lan Ni	လမ်းနီ
Marlar Kwae (Parami Road)	မာလာကွေ့ (ပါရမီလမ်း)
Kalar Kyaung	ကုလားကျောင်း
Kha Wae Chan (Baho Road)	ခဝဲခြံ (ဗဟိုလမ်း)
Kha Wae Chan (Insein Road)	ခဝဲခြံ (အင်းစိန်လမ်း)
Kyaik Wine	ကျိုက်ဝိုင်း
Ye Yan Aung	ရဲရန်အောင်
A One	အေဝမ်း
Mahar Si	မဟာစည်
Myaing Hay Wun Pan Chan	မြိုင်ဟေဝန်ပန်းခြံ
Shit Mile (Pyay Road)	၈ မိုင် (ပြည်လမ်း)
Ye Baw Haung	ရဲဘော်ဟောင်း
Hnit Zay (ThuDaMar)	(၂) စျေး (သုဓမ္မာ)
Hnit Zay (ArTharWaTi Road)	(၂) စျေး (အာသာဝတီလမ်း)
Kyaung Kwae (ArTharWadi Road)	ကျောင်းကွေ့ (အာသာဝတီလမ်း)
Kyaung Kwae (RC2)	ကျောင်းကွေ့ (RC2)
Kyaung Lan (Than Thu Mar)	ကျောင်းလမ်း (သံသုမာ)
Kyaung Lan (No 4 Road)	ကျောင်းလမ်း (အမှတ်(၄)လမ်း)
Lan Wa/ Nawaday	လမ်းဝ/နဝဒေး
Ngar Lan (Yuzana)	(၅)လမ်း (ယုဇန)
Oak Pon Seik	အုတ်ပုံဆိပ်
Phone Gyi Lan	ဘုန်းကြီးလမ်း
Lay-Thone-Ngar Hmat Taing	(၄၃၅) မှတ်တိုင်
Lay-Thone-Chauk Hmat Taing	(၄၃၆) မှတ်တိုင်
Kar Lay Gate (MaHarMyaing)	ကားလေးဂိတ် (မဟာမြိုင်)
Kar Lay Gate (MhawBi)	ကားလေးဂိတ် (မှော်ဘီ)
Saik Shae	စိုက်ရှေ့
A Way Pyay	အဝေးပြေး
Saw Bwar Gyi Kone (LanThit Road)	စော်ဘွားကြီးကုန်း (လမ်းသစ်လမ်း)
Koe Mile (Ocean)	၉မိုင် (အိုးရှင်း)
Koe Mile Khawe	၉ မိုင်ခွဲ
Myo Thit Zay	မြို့သစ်စျေး
Padauk Lan	ပိတောက်လမ်း
Bayint Naung Zay/ Zay Pwae Yone	ဘုရင့်နောင်စျေး/စျေးပွဲရုံ
B.P.I	ဘီပီအိုင်
Kyoe Kone (Baho Road)	ကြို့ကုန်း (ဗဟိုလမ်း)
Kyoe Kone (Insein Road)	ကြို့ကုန်း (အင်းစိန်လမ်း)
Kyoe Kone Lan Sone	ကြို့ကုန်းလမ်းဆုံ
Myoh Thit	မြို့သစ်
Aye Theikdi/ Thayet Taw	အေးသိဒ္ဓိ/ သရက်တော
Htaung Boo Wa	ထောင်ဘူးဝ
Insein Kannar	အင်းစိန်ကမ်းနား
Insein Zay	အင်းစိန်စျေး
Lay-sae-shit Gate	(၄၈) ဂိတ်
Min Zedi	မင်းစေတီ
Pauk Taw Wa (HlaingMyit Road)	ပေါက်တောဝ (လှိုင်မြစ်လမ်း)
Pauk Taw Wa (BaYintNaung Road)	ပေါက်တောဝ (ဘုရင့်နောင်လမ်း)
Sayardaw Gyi	ဆရာတော်ကြီး
Ywarma	ရွာမ
Ar Lain Ngar Sint	အာလိန်ငါးဆင့်
B.O.C (Insein Road)	ဘီအိုစီ (အင်းစိန်လမ်း)
B.O.C (KhaYan)	ဘီအိုစီ (ခရမ်း)
Insein Gon Tadar/ Hino Gate	အင်းစိန်ကုန်းတံတား/ ဟီးနိုးဂိတ်
Insein Say Yone Gyi	အင်းစိန်ဆေးရုံကြီး
Ma Nya Ka	မညက
Oakyin Wa (LanThit Road)	အုတ်ကျင်းဝ (လမ်းသစ်လမ်း)
Workshop (LanThit Road)	ဝပ်ရှော့ (လမ်းသစ်လမ်း)
Phot Kan Zay	ဖော့ကန်စျေး
Pyi Taw Thar	ပြည်တော်သာ
Pyi Taw Thar/ G.T.I Htate	ပြည်တော်သာ/(GTI)ထိပ်
Saung Hnit	ဆောင် (၂)
Thayet Taw (ThinGanKyun)	သရက်တော (သင်္ဃန်းကျွန်း)
Bo Kone	ဗိုလ်ကုန်း
Hight Pak	ဟိုက်ပက်
Pan Chan Kone	ပန်းခြံကုန်း
Tit-Koe-Koe Gate Haung (KhaYayPin Road)	(၁၉၉) ဂိတ်ဟောင်း (ခရေပင်လမ်း)
Aung San Zay	အောင်ဆန်းစျေး
Bo Chan	ဘိုခြံ
Kyaung Gate	ကျောင်းဂိတ်
Kyaung Zay (Dagon SateKan)	ကျောင်းစျေး (ဒဂုံဆိပ်ကမ်း)
Ywar Thit	ရွာသစ်
Asar Set	အစာစက်
Pan Chan	ပန်းခြံ
Khayae Pin Lan Khawe (Pyay Road)	ခရေပင်လမ်းခွဲ (ပြည်လမ်း)
Khayae Pin Lan Khawe (KhaYaePin Road)	ခရေပင်လမ်းခွဲ (ခရေပင်လမ်း)
Say Kyaung	ဆေးကျောင်း
Thone Yarthi	သုံးရာသီ
Yar Thet Pan	ရာသက်ပန်
Kyaikkasan Paya (Yadanar Road)	ကျိုက္ကဆံဘုရား (ရတနာလမ်း)
Suppaline (MhawBi)	ဆပ်ပလိုင်း (မှော်ဘီ)
Mingalardon Zay	မင်္ဂလာဒုံစျေး
Waryar Let	ဝါယာလက်
Yae Kyi I	ရေကြည်အိုင်
Alal Pauk	အလယ်ပေါက်
Ah-Hmat-Thone Lan Sone	အမှတ် (၃) လမ်းဆုံ
Oh Eain (PoneNarMe Road-Dagon SateKan)	အိုးအိမ် (ပုဏ္ဍမီလမ်း - ဒဂုံဆိပ်ကမ်း)
Oh Eain (Bago River Road-Dagon SateKan)	အိုးအိမ် (ပဲခူးမြစ်လမ်း - ဒဂုံဆိပ်ကမ်း)
Thingangyun	သင်္ဃန်းကျွန်း
Bo Chan	ဘိုခြံ
Hmoe Yon	မှိုရုံ
Set Yone Lan Sone (Dagon SateKan)	စက်ရုံလမ်းဆုံ (ဒဂုံဆိပ်ကမ်း)
London Set Yon	လန်ဒန်စက်ရုံ
Paya Lay Kwae (Dagon SateKan)	ဘုရားလေးကွေ့ (ဒဂုံဆိပ်ကမ်း)
Saing Bote	ဆိုင်းဘုတ်
Shan Su	ရှမ်းစု
Sin Min	ဆင်မင်း
Chauk Lan	(၆) လမ်း
Eain Yar Kwae	အိမ်ယာကွေ့
Palae Eain Yar	ပုလဲအိမ်ယာ
Palae Lan Sone	ပုလဲလမ်းဆုံ
Tadar Phyu (No 3 Main Road)	တံတားဖြူ (အမှတ် (၃) လမ်းမကြီး)
Tadar Phyu (No 6 Main Road)	တံတားဖြူ (အမှတ် (၆) လမ်းမကြီး)
Yakhine Kyaung	ရခိုင်ကျောင်း
C.P Light	စီပီလိုက်
Chan Pauk	ခြံပေါက်
Kon Ta La Paung	ကုန်းတလပေါင်
Kone Htate (Bo Min Yaung)	ကုန်းထိပ် (ဗိုလ်မင်းရောင်)
Lay Yat Kwet	(၄) ရပ်ကွက်
Mwae Myu Yae	မွေးမြူရေး
SayGirl	ဆေးဂဲလ်
Site Thit	ဆိုက်သစ်
Tat Yin Koe	တပ်ရင်း (၉)
War Saing	ဝါးဆိုင်
Yay Set	ရေစက်
Htauk Kyant Lan Sone	ထောက်ကြန့်လမ်းဆုံ
Oak Pho	အုတ်ဖို
PoneNya	ပုည
Thabarwa	သဘာဝ
Than Phyu	သံဖြူ
Thardukan	သာဓုကန်
Ye Chauk	ရဲ (၆)
Butar Zay	ဘူတာစျေး
Kyaung Lan (Yangon-Pyay Road)	ကျောင်းလမ်း (ရန်ကုန် -ပြည်လမ်း)
Kyaung Lan (Khay Mar Thi)	ကျောင်းလမ်း (ခေမာသီ)
Myin Hlae Gate	မြင်းလှည်းဂိတ်
Phone Gyi Kyaung	ဘုန်းကြီးကျောင်း
Sauk Lote Yae (ShweDagon Pagoda Road)	ဆောက်လုပ်ရေး (ရွှေတိဂုံဘုရားလမ်း)
Sit Tat	စစ်တပ်
Yay Sin	ရေစင်
Tit-Koe-Koe Gate Haung (Pale Road)	၁၉၉ ဂိတ်ဟောင်း (ပုလဲလမ်း)
Palae Lan	ပုလဲလမ်း
Phone Gyi Kyaung Kwae (East Dagon)	ဘုန်းကြီးကျောင်းကွေ့ (ရှေ့/ဒဂုံ)
Phone Gyi Kyaung Kwae (MinYeKyawSwar Road)	ဘုန်းကြီးကျောင်းကွေ့ (မင်းရဲကျော်စွာလမ်း)
Pyaw Bwal	ပျော်ဘွယ်
Tadar Htate (YaZaThinGyan Road)	တံတားထိပ် (ရာဇသင်္ကြန်လမ်း)
Zin Yaw	ဇင်ယော်
Shit-Sae-Tit Gate	(၈၁) ဂိတ်
Kar Gyi Gate (Bago Road)	ကားကြီးဂိတ် (ပဲခူးလမ်း)
Kar Lay Gate (ShwePyiThar)	ကားလေးဂိတ် (ရွှေပြည်သာ)
Khaung Thone Lone	ခေါင်သုံးလုံး
Say Khan	ဆေးခန်း
Shwe Nyar Maung	ရွှေညာမောင်
Taw Win Plaza	တော်ဝင်ပလာဇာ
Koe Thone Lone	ကိုးသုံးလုံး
Na-gyi Kwae	(ဏ) ကွေ့
Yone Shae (DU)	ရုံးရှေ့ (DU)
Yone Shae (50 Kwae)	ရုံးရှေ့ (၅၀ ကွေ့)
Kyaw Swar	ကျော်စွာ
Nga Mauk Zay	ငမောက်စျေး
Sin Hnat Kaung	ဆင်နှစ်ကောင်
Yay Chan Sin	ရေချမ်းစင်
Lower Gate	အောက်ဂိတ်
Aung Chan Thar (Dagon SateKan)	အောင်ချမ်းသာ (ဒဂုံဆိပ်ကမ်း)
Aung Chan Thar (Thanlyin)	အောင်ချမ်းသာ (သန်လျင်)
Aung Myittar	အောင်မေတ္တာ
Nyein Chan Yae	ငြိမ်းချမ်းရေး
Computer	ကွန်ပျူတာ
Kwet Thit (Dagon SateKan)	ကွက်သစ် (ဒဂုံဆိပ်ကမ်း)
Padonemar	ပဒုမ္မာ
Tar Sone	တာဆုံ
Tadar Phyu (Pyay Road)	တံတားဖြူ (ပြည်လမ်း)
Tadar Phyu (Min Ye Kyaw Swar)	တံတားဖြူ (မင်းရဲကျော်စွာ)
Dhamar Yone (HlaingTharYar)	ဓမ္မာရုံ (လှိုင်သာယာ)
YayOo Kan Zay Dhamar Yone	ရေအိုးကန်စျေးဓမ္မာရုံ
Thone Zay (MyinThawThar Road)	၃စျေး (မြင်တော်သာလမ်း)
Myoh Oo Kyaung	မြို့ဦးကျောင်း
See Pwar Yay University	စီးပွားရေးတက္ကသိုလ်
Mee Point	မီးပွိုင့်
Point Htake (ThanLwin Road)	ပွိုင့်ထိပ် (သံလွင်လမ်း)
Phoe Myay	ဖိုးမြေ
Yone Shae (No 3 Main Road)	ရုံးရှေ့ (အမှတ် (၃) လမ်းမကြီး)
(Ta) Yone Shae	(တ) ရုံးရှေ့
Out Kwae	အောက်ကွေ့
A Paw Kwae	အပေါ်ကွေ့
Aung Chan Thar (KyaukTan)	အောင်ချမ်းသာ (ကျောက်တန်း)
Aung Chan Thar (ShwePyiThar)	အောင်ချမ်းသာ (ရွှေပြည်သာ)
Sae-Shit Kone Htaik	(၁၈) ကုန်းထိပ်
Paya Shae (Thone Gwa)	ဘုရားရှေ့ (သုံးဂွ)
Nyaung Pin	ညောင်ပင်
Kunn Yar Saing (No 6 Road)	ကွမ်းယာဆိုင် (အမှတ်(၆)လမ်း)
Thama College	သမကောလိပ်
Nine Gate	(၉) ဂိတ်
Shit-Sae-Hnit	(၈၂)
Kyant Khaing Yae	ကြံ့ခိုင်ရေး
Yay Oh Sin	ရေအိုးစင်
Hnit Gate	(၂) ဂိတ်
Yoke Than	ရုပ်သံ
Ta-Sae-Ngar	တစ်ဆယ့်ငါး
Mee Sat	မီးစက်
Say Khan	ဆေးခန်း
Kyat Phyu Kan	ကြက်ဖြူကန်
Ye Baw Zay	ရဲဘော်စျေး
San Chaung Pauk	စမ်းချောင်းပေါက်
Main Ma Line	မိန်းမလိုင်း
Sae-Thit Taw	ဆယ့်တစ်တော
Koe-Sae-Tit Gate	(၉၁) ဂိတ်
Set Thwe Yay Gate Wa	ဆက်သွယ်ရေးဂိတ်ဝ
Set Thwe Yay (MhawBi)	ဆက်သွယ်ရေး (မှော်ဘီ)
Bo Thin Tan	ဗိုလ်သင်တန်း
Say Tat	ဆေးတပ်
Maw Taw Yin	မော်တော်ယာဉ်
Lay Tat	လေတပ်
Supply	ဆပ်ပလိုင်း
Sae-Chauk Gate	(၁၆) ဂိတ်
Yone Pauk	ရုံးပေါက်
Lay Sal Zay	၄၀ စျေး
A Hmat Lay	အမှတ် (၄)
Hmaw Bi Zay	မှော်ဘီစျေး
Thayet Taw Pauk	သရက်တောပေါက်
Mee Sat Pout	မီးစက်ပေါက်
Htan Ta Pin Tar Sone	ထန်းတပင်တာဆုံ
Su Paung Yone	စုပေါင်းရုံး
U Thu Mingala	ဦးသုမင်္ဂလ
Daung Lay Kwae	ဒေါင်းလေးကွေ့
Own Chan	အုန်းခြံ
G.T.C Site Thit	ဂျီတီစီဆိုက်သစ်
G.T.C Yay Oh	ဂျီတီစီရေအိုး
G.T.C Alal Pauk	ဂျီတီစီအလယ်ပေါက်
Aung Chan Thar (PhaungGyi)	အောင်ချမ်းသာ (ဖောင်ကြီး)
Aung Chan Thar Pyar Pone	အောင်ချမ်းသာပြာပုံ
Oak Set	အုတ်စက်
Myo Chaung	မြို့ချောင်း
Lan Ni Lay	လမ်းနီလေး
Japan Site	ဂျပန်ဆိုက်
Equator	အီကွေတာ
Phanat Sat	ဖိနပ်စက်
Baw Lone Sat Yone	ဘောလုံးစက်ရုံ
Baw Lone Ye Gate	ဘောလုံးရဲဂိတ်
Say War	ဆေးဝါး
Mani	မနီ
Kalar Kone	ကုလားကုန်း
Kyat Chan Pauk	ကြက်ခြံပေါက်
Chan Aye	ချမ်းအေး
Pha-Ye Khinn	ဖရဲခင်း
Than-Ma-Ni Sat Yon	သံမဏိစက်ရုံ
Hii Kue Nat Sin	ဟိုင်းကူးနတ်စင်
Nat Sin (HlaingTharYar)	နတ်စင် (လှိုင်သာယာ)
Kywe Lan	ကျွဲလမ်း
Myaung Takar Tar Sone	မြောင်းတကာတာဆုံ
Myaung Takar Sein Kalar	မြောင်းတကာစိန်ကုလား
Myaung Takar Yae Kyaw	မြောင်းတကာရေကျော်
Myauk Chaw Kone	မျောက်ချောကုန်း
Ywar Lal Pin	ရွာလယ်ပင်
Gone Kwae	ကုန်းကွေ့
Kyun Chaung	ကျွန်းချောင်း
Nga-Pyaw Taw	ငှက်ပျောတော
Yone Htein Thone	ရုံးထိန်း (၃)
Shwe Mya Yar	ရွှေမြယာ
Inn Yat Kyee	အင်းယက်ကြီး
Kan Kyee Daut (Dagon SateKan)	ကန်ကြီးထောင့် (ဒဂုံဆိပ်ကမ်း)
Kan Kone	ကန်ကုန်း
Taik Kyi Tar Gwa	တိုက်ကြီးတာခွ
Taik Kyi Phaung Gyi Lan Khwe	တိုက်ကြီးဖောင်ကြီးလမ်းခွဲ
Taik Kyi Khan Ma	တိုက်ကြီး ခန်းမ
MCC Khan Ma	MCC အမ်စီစီ ခန်းမ
Taik Kyi Zay	တိုက်ကြီးစျေး
Aung Thukha	အောင်သုခ
Yay Nan Gate Wa	ရေနံဂိတ်ဝ
Yay Nan Gate	ရေနံဂိတ်
Dar Gude	ဒါကုရ်
Myoma	မြို့မ
Myoma Zay	မြို့မစျေး
Kyar Paya	ကျားဘုရား
Sal Myaung (Thanlyin)	ဆည်မြောင်း (သန်လျင်)
Bahosi/ Mawtin	ဗဟိုစည်/ မော်တင်
Mit Zu Lan	မဉ္ဇူလမ်း
Mit Zu	မဥ္ဇူ
Nawaday	နဝဒေး
Ayar	ဧရာ
Paya Kone Lan Sone	ဘုရားကုန်းလမ်းဆုံ
Nat Sin Ta-Yar	နတ်စင်တစ်ရာ
San Set	ဆန်စက်
Kyaik Inn	ကျိုက်အင်း
Nat Sin Koun	နတ်စင်ကုန်း
Saw Bwar	စော်ဘွား
Ngar Su	ငါးစု
Hta Ma Lon	ထားမလုံ
Ko Tin Maung Chan Wa	ကိုတင်မောင်ခြံဝ
Aung Ta Pyay	အောင်သပြေ
Tit Road	(၁) လမ်း
Alal Ywar	အလယ်ရွာ
Hta Ma Ni Phone Gyi Kyaung Shae	ထမနီးဘုန်းကြီးကျောင်းရှေ့
Hta Ma Ni Gone Htate	ထမနီးကုန်းထိပ်
Saik Pyoe Yay	စိုက်ပျိုးရေး
Nyaung Wine	ညောင်ဝိုင်း
Mway Paya	မြွေဘုရား
Pa Da Kyi	ပါဒကြီး
Chan Myae Thar Yar	ချမ်းမြေ့သာယာ
Si Saing (Bago River Road-Dagon SateKan)	ဆီဆိုင် (ပဲခူးမြစ်လမ်း - ဒဂုံဆိပ်ကမ်း)
Pal Hlaw Pho	ပဲလှော်ဖို
Gat Tae Kwae	ဂါတ်တဲကွေ့
Kyauk Tan	ကျောက်တန်း
Ngone Chan	ငုံးခြံ
Chauk Htet Gyi	ခြောက်ထပ်ကြီး
Chauk Lan Twar	ခြောက်လမ်းသွား
Kyar Ni Kan	ကြာနီကန်
Nay La	နေလ
Chaung Tit	ချောင်း (၁)
Sit Pin Kwinn	စစ်ပင်ကွင်း
Nyaung Pin Lay Zay	ညောင်ပင်လေးစျေး
Ma Yin Kwae	မရင်ကွေ့
Ta-Htay Kwinn	သူဌေးကွင်း
Kayin Seik Anout Phyar	ကရင်ဆိပ်အနောက်ဖျား
Kayin Seik Thama	ကရင်ဆိပ်သမ
Chin Ma Lay Kayin Seik	ချင်းမလေးကရင်ဆိပ် (ကရင်ဆိပ်)
Shwe Htan Pin	ရွှေထန်းပင်
San Da Thu	ဆန္ဒတူ
Palae Maw Taw Seik	ပုလဲမော်တော်ဆိပ်
Palae	ပုလဲ
Kan Myint	ကံမြင့်
Ou Yin Thar	ဥယာဉ်သာ
Kar Gyi Tae	ကားကြီးတဲ
Pyinn Ma Kan	ပျဉ်းမကန်
Taung Mo/ Hle Lan	တောင်မို့/လှည်းလမ်း
Bo Tae Kone	ဗိုလ်တဲကုန်း
Five Star	ဖိုက်စတား
Tadar Ni	တံတားနီ
Pwint Oo	ပွင့်ဦး
Taik Tu Kan	တိုက်တူးကန်
Nyaung Ni Tadar	ညောင်နီတံတား
Hnit Htat Kwae	နှစ်ထပ်ကွေ့
Own Tadar	အုန်းတံတား
Ye Nwe	ရဲနွယ်
U Tin Hla Tadar	ဦးတင်လှတံတား
Ngapi Oak Pauk	ငပိအုတ်ပေါက်
Paya Lay Tadar	ဘုရားလေးတံတား
War Tadar (No 6 Road)	ဝါးတံတား (အမှတ်(၆)လမ်း)
Mee Thar Su Tadar	မိသားစုတံတား
Kyo So Par Ei	ကြိုဆိုပါ၏
Saik Pyoe Yay Kwae	စိုက်ပျိုးရေးကွေ့
Khun Htate	ခွန်ထိပ်
Lay Saing	လေဆိုင်
Shwe Pu Zun Kwae	ရွှေပုစွန်ကွေ့
Ban Shae	ဘဏ်ရှေ့
Htauk Kyant Lan Sone	ထောက်ကြန့်လမ်းဆုံ
Myo Shouk Lan	မြို့လျှောက်လမ်း
Ka Lai Htaw	ကလိုင်ထော်
Sain Lae Oo	စိမ်းလဲ့ဦး
A Mhat Thone	အမှတ် (၃)
Htan Pin Kan	ထန်းပင်ကန်
Shwe War Myay	ရွှေဝါမြေ
Yadanar Myay	ရတနာမြေ
Kyun Ka Lay	ကျွန်းကလေး
Yate Thein	ရိတ်သိမ်း
A Nout Zayat (Hle Gu)	အနောက်ဇရပ် (လှည်းကူး)
A Shae Dagon (Htan Ta Pin)	အရှေ့ဒဂုံ (ထန်းတပင်)
A Shae Zayat	အရှေ့ဇရပ်
Ar-zi-wa	အာဇီဝ
Sein Nagar	စိန်နဂါး
Yankin Ngar Lan	ရန်ကင်း (၅) လမ်း
Yone Shae (ShwePyiThar)	ရုံးရှေ့ (ရွှေပြည်သာ)
Yone Shae (KyanSitThar Road-HlaingTharYar)	ရုံးရှေ့ (ကျန်စစ်သားလမ်း-လှိုင်သာယာ)
Yoma Yeik Thar	ရိုးမရိပ်သာ
Yeik Thar	ရိပ်သာ
Hlegu Zay	လှည်းကူးစျေး
Thin Zar Oo	သဥ္ဇာဦး
Oo Khway Pu	ဦးခွေးပု
San Taw Tar	စန်းသော်တာ
Nyaung Pin	ညောင်ပင်
Sal Myaung Yone (Phaung Gyi)	ဆည်မြောင်း (ဖောင်ကြီး)
Ngapi Tae	ငပိတဲ
Sakhan Kyi	စခန်းကြီး
Mhan Kone	မှန်ကုန်း
Htain Thone Pin	ထိန်သုံးပင်
Ka Li Htaw	ကလီထော်
Aung Ta Pyay	အောင်သပြေ
Kyar Kan	ကြာကန်တံတား
Ka Dit	ကဒစ်
Nat-Khan-Mhway Taik	နှုတ်ခမ်းမွှေးသိုက်
Si Own	ဆီအုန်း
Tha Pyay Kone	သပြေကုန်း
Sar Oo	စာဥ
Sar Boo Taung	စာဘူးတောင်း
A Myan Lan Sone	အမြန်လမ်းဆုံ
Khun/ Shit Lan Sone (YarZaDaRitz Road)	၇/၈ လမ်းဆုံ (ရာဇဓိရာဇ်လမ်း)
Nyaung Kone	ညောင်ကုန်း
Kyo Kone Exchange Yone	ကြို့ကုန်းအိတ် (စ်)ချိန်းရုံး
Koo Paung	ကူပေါင်း
Hine Koo	ဟိုင်းကူး
Ou Yin Wa	ဥယျာဉ်ဝ
Tha Pyay Taung	သပြေတောင်
Ou Yin Wa Lan Thit	ဥယျာဉ်ဝလမ်းသစ်
Paya Kone	ဘုရားကုန်း
Si Pin Lan Khwe	စည်ပင်လမ်းခွဲ
Phaung Gyi Tar Sone	ဖောင်ကြီးတာဆုံ
Say Yone Kone	ဆေးရုံကုန်း
Baho Wun Htan University	ဗဟိုဝန်ထမ်းတက္ကသိုလ်
San Pya	စံပြ
Thama War Ya Ma College	သမဝါယမကောလိပ်
Min Kone	မင်းကုန်း
Chan Wine	ခြံဝိုင်း
Lay Daung Kan (Site Mway Tit)	လေးထောင့်ကန် (ဆိုက်မွေး-၁)
Yeik Thar (Bago Road)	ရိပ်သာ (ပဲခူးလမ်း)
Out Ywar Yeik Thar	အောက်ရွာရိပ်သာ
Thama	သမ
U Khway Pu	ဦးခွေးပု
Moke Pho	မုန့်ဖို
Tha Pyay Chan	သပြေခြံ
December Moke Oo	ဒီဇင်ဘာမုခ်ဦး
December Alal Pauk	ဒီဇင်ဘာအလယ်ပေါက်
A Aye Khan	အအေးခန်း
Kyo So Yay (No 2 Main Road)	ကြိုဆိုရေး (အမှတ်(၂)လမ်းမကြီး)
Sal Myaung (No 2 Road)	ဆည်မြောင်း (အမှတ်(၂)လမ်း)
Sal Myaung (Hlegu)	ဆည်မြောင်း (လှည်းကူး)
Tayar-Lay-Sae	တစ်ရာ့လေးဆယ်
Kyaung Shae (Sii Pin Road)	ကျောင်းရှေ့ (စည်ပင်လမ်း)
Nyaung Pin	ညောင်ပင်
A Kauk Khun	အကောက်ခွန်
Sate Kyan Mar Yae Say Yone	စိတ်ကျန်းမာရေးဆေးရုံ
Technology University (G.T.U)	နည်းပညာတက္ကသိုလ်(ဂျီတီယူ)
West Yangon University	အနောက်ပိုင်းတက္ကသိုလ်
Sal Mile Kone	၁၀ မိုင်ကုန်း
Yone Shae (ThaYat Pin)	ရုံးရှေ့ (သရက်ပင်)
Thone-sae-tit Gate Haung (South OakKaLar)	(၃၁) ဂိတ်ဟောင်း (တောင်ဥက္ကလာ)
Thanat Pyit Kwin	သေနတ်ပစ်ကွင်း
Kyaetamar	ကျေးတမာ
Paya Lan (KyanSitThar Road-HlaingTharYar)	ဘုရားလမ်း (ကျန်စစ်သားလမ်း-လှိုင်သာယာ)
Yone Shae (HlawKar Road)	ရုံးရှေ့ (လှော်ကားလမ်း)
Phone Gyi Kyaung Kwae (Bago River KanNar)	ဘုန်းကြီးကျောင်းကွေ့ (ပဲခူးမြစ်ကမ်းနား)
Phone Gyi Kyaung Kwae (YarZaDaRitz Road)	ဘုန်းကြီးကျောင်းကွေ့ (ရာဇဓိရာဇ်လမ်း)
Thit Saing Kwae (KhaYan)	သစ်ဆိုင်ကွေ့ (ခရမ်း)
Thone-Sae-Hnit Gate	(၃၂) ဂိတ်
Kanaung Eain Yar	ကနောင်အိမ်ယာ
Kyaetamar	ကျေးတမာ
Kanaung Kwae	ကနောင်ကွေ့
Chauk-Sae-Hnit	(၆၂)
Myittar Shwe Yi	မေတ္တာရွှေရည်
Sagar Wah	စကားဝါ
Sat Yone Shae (Lay Htaut Kan)	စက်ရုံရှေ့ (လေးထောင့်ကန်)
Sat Yone Shae (Ka Mar Kyi Road)	စက်ရုံရှေ့ (ကမာကြည်လမ်း)
Sae-Chauk Kwae	၁၆ကွေ့
Parami NyaungPin	ပါရမီညောင်ပင်
Parami (Dagon SateKan)	ပါရမီ (ဒဂုံဆိပ်ကမ်း)
Thone-Htet Kyaung Kwae	သုံးထပ်ကျောင်းကွေ့
Insein Pan Chan (LanThit Road)	အင်းစိန်ပန်းခြံ (လမ်းသစ်လမ်း)
Thamine Station (Baho Road)	သမိုင်းဘူတာ (ဗဟိုလမ်း)
Insein Say Yone Gyi	အင်းစိန်ဆေးရုံကြီး
Lan Thit (No 2 Main Road)	လမ်းသစ် (အမှတ်(၂)လမ်းမ)
Lan Thit	လမ်းသစ်
Shwe La Min	ရွှေလမင်း
Sin Phon Kwae	ဆင်ဖုံကွေ့
Kyauk Lan Htate (Bagan Road)	ကျောက်လမ်းထိပ် (ပုဂံလမ်း)
Ocean (MaHarBanDuLa Road)	အိုးရှင်း (မဟာဗန္ဓုလလမ်း)
Ocean (Lower PaZunDaung Road)	အိုးရှင်း (အောက်ပုဇွန်တောင်လမ်း)
Out Htate	အောက်ထိပ်
Toe Chae	တိုးချဲ့
Mee Khwat Zay (BoAungKyaw)	မီးခွက်စျေး (ဗိုလ်အောင်ကျော်)
Zay Lan	စျေးလမ်း
Arr Man	အားမာန်
Yoe Gyi	ရိုးကြီး
Tayar-Tone Gate Haung	(၁၀၃) ဂိတ်ဟောင်း
Kan Baw Za	ကမ္ဘာဇ
Gate Haung (BaHtoo Road)	ဂိတ်ဟောင်း (ဗထူးလမ်း)
Ayar Myay	ဧရာမြေ
Computer	ကွန်ပျူတာ
Saw Bwar Gyi Kone (Pyay Road)	စော်ဘွားကြီးကုန်း (ပြည်လမ်း)
Koke Kine	ကုက္ကိုင်း
Inya Myaing	အင်ယာမြိုင်
Thanlwin	သံလွင်
U.F.L	ယူအပ်ဖ်အယ်
Thanlwin	သံလွင်
Hlegu Tar Sone	လှည်းကူးတာဆုံ
Khun/ Shit Lan Sone (MinYeKyawSwar Road)	၇/၈ လမ်းဆုံ (မင်းရဲကျော်စွာလမ်း)
Dagon Ayar A Way Pyay	ဒဂုံဧရာအဝေးပြေး
Kili	ကီလီ
Nyaung Pin Lay Zay	ညောင်ပင်လေးစျေး
Latha (AhNawYaHtar Road)	လသာ (အနော်ရထာလမ်း)
Shwe Pyi Thar Kwae	ရွှေပြည်သာကွေ့
Bayint Naung Lan Sone	ဘုရင့်နောင်လမ်းဆုံ
Shwe Lin Pan	ရွှေလင်ပန်း
Ywar Htate	ရွာထိပ်
Ma Da	မဓ
Aung Taw My	အောင်တော်မူ
A Mhite Pone	အမိုက်ပုံး
Than Lyet Soon	သံလျှက်စွန်း
Waibargi	ဝေဘာဂီ
Myoh Thit	မြို့သစ်
Gate Haung	ဂိတ်ဟောင်း
Baho Bank	ဗဟိုဘဏ်
Kyel Ngar Pwint	ကြယ်ငါးပွင့်
Wizaya Plaza	ဝိဇယပလာဇာ
Shwe Myin Pyan	ရွှေမြင်းပျံ
Paya Lan (Lay Htaut Kan)	ဘုရားလမ်း (လေးထောင့်ကန်)
Thuwunna Lan Sone	သုဝဏ္ဏလမ်းဆုံ
Khayae Pin Yate Mon	ခရေပင်ရိပ်မွန်
Lay Har Pyin Zay	လေဟာပြင်စျေး
Thamine Lan Son	သမိုင်းလမ်းဆုံ
Moke Wa AHtwat (DU)-KyanSitThar Road	မုခ်ဝအထွက် (DU) - ကျန်စစ်သားလမ်း
Gate Haung	ဂိတ်ဟောင်း
Pathein Kyaung Lan	ပုသိမ်ကျောင်းလမ်း
Thein Kyaung Lan Sone (Bago River Road)	သိမ်ကျောင်းလမ်းဆုံ (ပဲခူးမြစ်လမ်း)
Shit Thama	၈ သမ
Bhone Gyi Kyaung Kwae (ShwePyiThar)	ဘုန်းကြီးကျောင်းကွေ့ (ရွှေပြည်သာ)
Mat Tine Thit	မှတ်တိုင်သစ်
Zay Mat Tine	စျေးမှတ်တိုင်
Say Yone Shae	ဆေးရုံရှေ့
Sae-Thone Lan	၁၃ လမ်း
Gate Haung	ဂိတ်ဟောင်း
Phone Gyi Lan	ဘုန်းကြီးလမ်း
Thakhin Mya Pan Chan	သခင်မြပန်းခြံ
Damaryone Lan	ဓမာရုံလမ်း
Ayat Sine Kwae	အရက်ဆိုင်ကွေ့
Kyauk Kwae	""
Sae-Tit Lan (PoneNarMe)	၁၁ လမ်း (ပုဏ္ဍမီ)
Kyauk Kwae	ကျောက်ကွေ့
Koe-Sae-Tit Lan	၉၁ လမ်း
Phuu Gyi Lan	ဖူးကြီးလမ်း
Nyaung Pin	ညောင်ပင်
Myawaddy Min Gyi	မြဝတီမင်ကြီးလမ်း
U Tun	ဦးထွန်း
Set Hmu Zone (KaNaungMinTharGyi Road)	စက်မှုဇုန် (ကနောင်မင်းသားကြီးလမ်း)
U Mye	ဦးမြဲ
Gandamar HoSale (MyohHtal)	ဂန္ဓမာဟိုးဆေး(မြို့ထဲ)
Byamaso	ဗြဟ္မစိုရ်
Yadanar Lan (MyohHtal)	ရတနာလမ်း(မြို့ထဲ)
Yadanar Lan (MyohPyin)	ရတနာလမ်း(မြို့ပြင်)
Pyithaya	ပြည်သာယာ
Zay Kwae	စျေးကွေ့
Alote Thamar Say Yone	အလုပ်သမားဆေးရုံကြီး
Marine University	ရေကြောင်းတက္ကသိုလ်
Yay Kyaung Lan Sone	ရေကြောင်းလမ်းဆုံ
Phar Out	ဖားအောက်
Kyeik Kouk Phayar	ကျိုက်ခေါက်ဘုရား
Yangon International Airport Terminal 2	ရန်ကုန်လေဆိပ် တာမီနယ် (၂)
Phoe Sein Lan	ဖိုးစိန်လမ်း
Thama Kone Lan Sone	သမကုန်းလမ်းဆုံ
Tine Yin Tharr Nee Pyin Nyar	တိုင်းရင်းသားနည်းပညာသက္ကသိုလ်
Yadanar Lann	ရတနာလမ်း
Hnin Si Kone Phoe Phwar Yeik Thar	နှင်းဆီကုန်းဘိုးဘွားရိပ်သာ
Thel Phyu Yeik Thar	သဲဖြူရိပ်သာ
Shwe Li Road	ရွှေလီလမ်း
Thanghar University	သံဃာတက္ကသိုလ်
Parami Lan Sone	ပါရမီလမ်းဆုံ
Parami SeinGayHar	ပါရမီစိန်ဂေဟာ
Hantharwaddy Road	ဟံသာဝတီလမ်း
Thuwanna Stadium (MyohHtal)	သုဝဏ္ဏဘောလုံးကွင်း(မြို့ထဲ)
Thuwanna Stadium (MyohPyin)	သုဝဏ္ဏဘောလုံးကွင်း(မြို့ပြင်)
Okkan	ဥက္ကံ
Min Dhamma Eain Yar	မင်းဓမ္မအိမ်ယာ
Paduak Lan	ပိတောက်လမ်း
Yangon International Airport Terminal 1	ရန်ကုန်လေဆိပ် တာမီနယ် (၁)
Yangon International Airport Terminal 3	ရန်ကုန်လေဆိပ် တာမီနယ် (၃)
Yangon International Airport Car Parking	ရန်ကုန်လေဆိပ် ကားပါကင်
Yangon Central Railway Station	ရန်ကုန်ဘူတာကြီး
Yay Sin Lan	ရေဆင်းလမ်း
Hle Gu (Pyi Taw Thar)	လှည်းကူး(ပြည်တော်သာ)
University of Education	ပညာရေးကောလိပ်
Baw Di Pin	ဗောဓိပင်
Da Ye Pho Sal Myaung	ဒရဲဖိုဆည်မြောင်း
Pout Kone	ပေါက်ကုန်း
War Tadar (Hle Gu)	ဝါးတံတား(လှည်းကူး)
War Tadar (Yangon-Pathein Road)	ဝါးတံတား (ရန်ကုန်- ပုသိမ်လမ်း)
Nyaung Kone War Ta Dar	ညောင်ကုန်းဝါးတံတား
Ta Dar Ho Bat Htaik	တံတားဟိုဘက်ထိပ်
Ta Dar Di Bat Htaik	တံတားဒီဘက်ထိပ်
Wa Nat Kone Kyaung Shae	ဝနက်ကုန်းကျောင်းရှေ့
Ye Mon Tat Myoh	ရဲမွန်တပ်မြို့
Lan Thit (Ye Mon)	လမ်းသစ်(ရဲမွန်)
Ye Mon Monastery	ရဲမွန်ဘုန်းကြီးကျောင်း
Kyauk Ta Lone	ကျောက်တလုံး
COD Kyaung	စီအိုဒီကျောင်း
COD Zay	စီအိုဒီစျေး
Koe Shit Tit	ကိုးရှစ်တစ် ၉၈၁
Say Yone Haung	ဆေးရုံဟောင်း
Za Yat Kwin Than Lan	ဇရပ်ကွင်းသံလမ်း
Za Yat Kwin Lan Sone	ဇရပ်ကွင်းလမ်းဆုံ
Site Kar Gate (Za Yat Kwin)	ဆိုက်ကားဂိတ် (ဇရပ်ကွင်း)
Ywar Pout (Za Yat Kwin)	ရွာပေါက် (ဇရပ်ကွင်း)
Zay Shae (Za Yat Kwin)	စျေးရှေ့ (ဇရပ်ကွင်း)
Than Lan (Za Yat Kwin Bu Tar)	သံလမ်း (ဇရပ်ကွင်းဘူတာ)
Say Khan (Za Yat Kwin)	ဆေးခန်း (ဇရပ်ကွင်း)
Ywar Lal (Za Yat Kwin)	ရွာလယ် (ဇရပ်ကွင်း)
Lan Thit (Za Yat Kwin)	လမ်းသစ် (ဇရပ်ကွင်း)
Gandamar Pout	ဂန္ဓမာပေါက်
San Yay Pyar	စမ်းရေပြာ
PhaYar Gate	ဘုရားဂိတ်
Inn Tine Win Htan	အင်တိုင်ဝန်ထမ်း
A Lal Tan Kyaung Shae	အလယ်တန်းကျောင်းရှေ့
Kyauk Sat	ကျောက်စက်
Ta Laut Kone	တလုတ်ကုန်း
Wa Rone Son Yay Nan	ဝရုန်စွန်းရေနံ
Sal Myaung (Tha Nat Pyin)	ဆည်မြောင်း (သနပ်ပြင်)
Oo Phoe Kwae	ဦးဖိုးကွေ့
Kan Myint A Nout Za Yat	ကံမြင့်အနောက်ဇရပ်
A Nout Zayat (No 2 Main Road)	အနောက်ဇရပ် (အမှတ် (၂)လမ်းမကြီး)
Ywar Win Yay Nan	ရွာဝင်ရေနံ
Yay Oh Sin (Sar Ta Lynn)	ရေအိုးစင် (ဆားတလင်း)
Nhit Ywar Kyar Yay Oh Sin	(၂)ရွာကြားရေအိုးစင်
Yay Oh Sin (Pepsi)	ရေအိုးစင် (ပက်စီ)
Yay Oh Sin (Phaung Gyi)	ရေအိုးစင် (ဖောင်ကြီး)
Yay Oh Sin (No 2 Road)	ရေအိုးစင် (အမှတ်(၂)လမ်း)
Sar Ta Lynn Sat Shae	ဆားတလင်းစက်ရှေ့
Ywar Lal (Sar Ta Lynn)	ရွာလယ် (ဆားတလင်း)
Kyoh Kone Ywar Lal Kyaung	ကြို့ကုန်းရွာလယ်ကျောင်း
Sar Bu Taung Ywar Lal	စာဗူးတောင်းရွာလယ်
Ka Dit Ywar Lal	ကဒစ်ရွာလယ်
Mhan Kone Ywar Lal	မှန်ကုန်းရွာလယ်
Myout Chaw Kone Ywar Lal	မြောက်ချောကုန်း ရွာလယ်
Sar Ta Lynn Lan Sone	ဆားတလင်းလမ်းဆုံ
Sar Ta Lynn Kyaung Shae	ဆားတလင်းကျောင်းရှေ့
Sar Ta Lynn Pan Chan	ဆားတလင်းပန်းခြံ
Tha Ma Sine (Sar Ta Lynn)	သမဆိုင် (ဆားတလင်း)
Bhone Gyi Kyaung Shae (Sar Ta Lynn)	ဘုန်းကြီးကျောင်းရှေ့ (ဆားတလင်း)
Kyar Kan Lan Thit	ကြာကန်လမ်းသစ်
Kyar Kan Ywar	ကြာကန်ရွာ
Kyar Kan Sal Myaung	ကြာကန် ဆည်မြောင်း
Nga Yote Pho Ta Dar	ငရုတ်ဖိုတံတား
Phoe Taw Pout	ဘိုးတော်ပေါက်
Ywar A Win Yay Kan	ရွာအဝင်ရေကန်
A Htet Ywar Kyaung Shae	အထက်ရွာကျောင်းရှေ့
A Htet Ywar Kyaung	အထက်ရွာကျောင်း
A Htin Sat	အထင်စက်
Nwar Chan (No 2 Road)	နွားခြံ (အမှတ်(၂) လမ်း)
Out Ywar Ta Dar	အောက်ရွာတံတား
Out Ywar Kyaung	အောက်ရွာကျောင်း
Out Sat	အောက်စက်
Out Ywar Si Sine	အောက်ရွာဆီဆိုင်
Nay La Pout (No 2 Road)	နေလပေါက် (အမှတ်(၂)လမ်း)
Daw Pyar Pout	ဒေါ်ပြားပေါက်
Tat Pout	တပ်ပေါက်
Aung Kay Thar A Lal Pout	အောင်ကေသာအလယ်ပေါက်
Aung Kay Thar Pa Hta Ma Pout	အောင်ကေသာပထမပေါက်
Than Lan Kwae	သံလမ်းကွေ့
Than Lan Kwae (Lay Htaut Kan)	သံလမ်းကွေ့ (လေးထောင့်ကန်)
Than Lan Kwae (Dar Pain)	သံလမ်းကွေ့ (ဒါးပိန်)
Kan Tharyar (Khay Mar Thi)	ကန်သာယာ (ခေမာသီ)
Aung Mingalar A Way Pyay (Sike Yauk)	အောင်မင်္ဂလာအဝေးပြေး (ဆိုက်ရောက်)
Yadanar Lan Sone (YuZaNa)	ရတနာလမ်းဆုံ (ယုဇန)
Point Htake (AyarWunSakSat)	ပွိုင့်ထိပ် (ဧရာဝဏ်ဆက်စပ်)
Thit Saing Kwae (PyiDaungSu Road)	သစ်ဆိုင်ကွေ့ (ပြည်ထောင်စုလမ်း)
Yin Kyay Mhu	ယဥ်ကျေးမှု
Taung Myout Lan Sone (PyiDaungSu Road)	တောင်မြောက်လမ်းဆုံ (ပြည်ထောင်စုလမ်း)
Sanpya Zay (ThanThuMar)	စံပြစျေး (သံသုမာ)
Sule Square	ဆူးလေစကွဲ
Lan Ngar Sae (BoGyoke Road)	လမ်း ၅၀ (ဗိုလ်ချုပ်လမ်း)
Hnin Si Eain Yar	နှင်းဆီအိမ်ယာ
Yadanar Lan Sone (ShweLi Road)	ရတနာလမ်းဆုံ (ရွှေလီလမ်း)
West Moke Oo (YuZaNa)	အနောက်မုခ်ဦး (ယုဇန)
BayLuWa Kwae	ဗေလုဝကွေ့
Lay-sae-koe Gate Haung (BoMinYaung)	(၄၉) ဂိတ်ဟောင်း (ဗိုလ်မင်းရောင်)
Myayni Lan (ThoneKhwa)	မြေနီလမ်း (သုံးခွ)
Myayni Lan (HlaingTharYar)	မြေနီလမ်း (လှိုင်သာယာ)
Myayni Lan (LayHtaukKan)	မြေနီလမ်း (လေးထောင့်ကန်)
Myaynigone (PyiThuYinPyin)	မြေနီကုန်း (ပြည်သူ့ရင်ပြင်)
Lan Ngar Sae (AhNawYaHtar)	လမ်း ၅၀ (အနော်ရထာ)
Kone Zay Tan (MaHarBanDuLa Road)	ကုန်စျေးတန်း (မဟာဗန္ဓုလလမ်း)
Lan Ngar Sae (MaHarBanDuLa Road)	လမ်း ၅၀ (မဟာဗန္ဓုလလမ်း)
Zay Shae (East Dagon)	စျေးရှေ့ (ရှေ့ဒဂုံ)
Ah Htal Choke (Shwe-Dagon SateKan)	အထည်ချုပ် (ရွှေ - ဒဂုံဆိပ်ကမ်း)
YarZa Jo	ရာဇဂြိုလ်
BayLuWa Kwae (Yadanar Road)	ဗေလုဝကွေ့ (ရတနာလမ်း)
Sar Taik (KaBarAye)	စာတိုက် (ကမ္ဘာအေး)
Sar Taik (ThuMingalar Road)	စာတိုက် (သုမင်္ဂလာလမ်း)
Sar Taik (MingalarDone)	စာတိုက် (မင်္ဂလာဒုံ)
Sar Taik (MhawBi)	စာတိုက် (မှော်ဘီ)
Shit-Mile Yangon Hotel (MyaingHayWun)	၈ မိုင် ရန်ကုန်ဟိုတယ် (မြိုင်ဟေဝန်)
Tit Htate (HlaingMyit Road)	၁ ထိပ် (လှိုင်မြစ်လမ်း)
Kyaung Shae (KyanSitThar Road)	ကျောင်းရှေ့ (ကျန်စစ်သားလမ်း)
Kye Su	ကျီစု
Tit-Chauk_Shit Yat Kwat Htake	၁၆၈ ရပ်ကွက်ထိပ်
Kyo So Yay (TharKayTa)	ကြိုဆိုရေး (သာကေတ)
Thar Gaung Gyi	သာဂေါင်ကြီး
Mya Nandar (Thanlwin Road)	မြနန္ဒာ (သံလွင်လမ်း)
Yadanar Lan Sone (ThanLwin Road)	ရတနာလမ်းဆုံ (သံလွင်လမ်း)
Inwa (South OakKaLar)	အင်းဝ (တောင်ဥက္ကလာ)
Paya Lay Kwae (TharKayTa)	ဘုရားလေးကွေ့ (သာကေတ)
TharKayTa Ah Wine (ShuKhinThar Road)	သာကေတအဝိုင်း (ရှုခင်းသာလမ်း)
Gate Haung (TharKayTa)	ဂိတ်ဟောင်း (သာကေတ)
Kyaung Shae Waizayanar	ကျောင်းရှေ့ဝေဇယန္တာ
Khun Zay (Khun Zay Road)	၇စျေး (၇စျေးလမ်း)
Man Pyae (ThuMaNa Road)	မာန်ပြေ (သုမနလမ်း)
Yan Pyay (ThuMaNa Road)	ရန်ပြေ (သုမနလမ်း)
Myat Si Say Yone	မျက်စိဆေးရုံ
Gate Haung (Dagon SateKan)	ဂိတ်ဟောင်း (ဒဂုံဆိပ်ကမ်း)
Dhama Yone (Dagon SateKan)	ဓမ္မရုံ (ဒဂုံဆိပ်ကမ်း)
Sa Gate	စဂိတ်
Tit Zay Kwae (ZinGaMar)	၁ စျေးကွေ့ (ဇင်ဂမာ)
Sae-Lay/Sae-Ngar Lan Sone (ThuMingaLar)	၁၄/၁၅ လမ်းဆုံ (သုမင်္ဂလာ)
Padaythar Lan Sone (ThuMingaLar Road)	ပဒေသာလမ်းဆုံ (သုမင်္ဂလာလမ်း)
Marlar Kwae (ThuMingaLar Road)	မာလာကွေ့ (သုမင်္ဂလာလမ်း)
Ngar-Lan (North OakKaLar)	(၅) လမ်း (မ/ဥက္ကလာ)
Moke Wa AHtwat (DU)	မုဒ်ဝအထွက် (DU)
Ta Tha Tha	တသသ
Sal Mile-Tit (DU)	၁၀ မိုင် - ၁ (DU)
Thone-Sae-Khun (DU)	၃၇ (DU)
Thone-Sae-Chauk (DU)	၃၆ (DU)
Thone-Sae-Ngar (DU)	၃၅ (DU)
Nhit-ThoneNya-Ngar Kwae	၂၀၅ ကွေ့
Thone Lan Sone (KhaYayPin LanKhwel)	(၃) လမ်းဆုံ (ခရေပင်လမ်းခွဲ)
Say Kyaung (Mingalardon)	ဆေးကျောင်း (မင်္ဂလာဒုံ)
Noh Zay	နို့စျေး
Pann Zay	ပန်းစျေး
Kyo Kone Paya Zay Sine	ကြို့ကုန်းဘုရားစျေးဆိုင်
Kyo Kone OakKaHta Eain Shae	ကြို့ကုန်းဥက္ကဌအိမ်ရှေ့
Kyo Kone Yone San	ကြို့ကုန်းရုံးစံ
Kyo Kone Phone Kyee Kyaung Lan	ကြို့ကုန်းဘုန်းကြီးကျောင်းလမ်း
Kyo Kone (BaYintNaung Road)	ကြို့ကုန်း (ဘုရင့်နောင်လမ်း)
Ngar-sae Kwae (North Dagon)	၅၀ ကွေ့ (မ/ဒဂုံ)
Ngar-sae Kwae Lan Sone (North Dagon)	၅၀ ကွေ့လမ်းဆုံ (မ/ဒဂုံ)
Ma Wa Ta (PinLone Lan)	မ.ဝ.တ (ပင်လုံလမ်း)
Thone-Sae-Ngar (North Dagon)	၃၅ (မ/ဒဂုံ)
Lan Sone (U Chit Maung)	လမ်းဆုံ (ဦးချစ်မောင်)
Tamwe Ah Wine (U Chit Maung)	တာမွေအဝိုင်း (ဦးချစ်မောင်)
Tamwe Ah Wine (Shwe Gong Dine)	တာမွေအဝိုင်း (ရွှေဂုံတိုင်)
Pha Sa Pa La (Yout Road)	ဖဆပလ (ယောက်လမ်း)
Ah Shae Shwe Gong Daing	အရှေ့ရွှေဂုံတိုင်
Ngar Htat Kyee Paya	ငါးထပ်ကြီးဘုရား
Banyar	ဗညား
Law Pi Ta	လောပိတ
Thone-sae-Ngar (Bo Min Yaung)	၃၅ (ဗိုလ်မင်းရောင်)
Lan Ngar Sae (Bo Ta Htaung)	လမ်း ၅၀ (ဗိုလ်တစ်ထောင်)
Lay-Sae-Chauk Lan (MaHar BanDuLa Road)	၄၆ လမ်း (မဟာဗန္ဓုလလမ်း)
UFL	ယူ အက် (ဖ်) အယ်
Myanmar Plaza (Lan Ni Lay)	မြန်မာပလာဇာ (လမ်းနီလေး)
Moe Swe	မိုးဆွေ
Sae-Lay/Sae-Ngar Lane Sone (Yadana Road)	၁၄/၁၅ လမ်းဆုံ (ရတနာလမ်း)
Sae-Chauk Kwae (Yadana Road)	(၁၆) ကွေ့ (ရတနာလမ်း)
Ah Wine Lay(Yan Kain)	အဝိုင်းလေး (ရန်ကင်း)
Sae-Nhit Lone Tan Kwae(Yan Shin Road)	(၁၂)လုံးတန်းကွေ့ (ရန်ရှင်းလမ်း)
Kok Kei(TatkaTho YeikThar Road)	ကုက္ကိုင်း (တက္ကသိုလ်ရိပ်သာလမ်း)
Yay Sat Kwae(ThanLwin)	ရေစက်ကွေ့ (သံလွင်)
Than Lwin(TatKaTho YeikThar Road)	သံလွင် (တက္ကသိုလ်ရိပ်သာလမ်း)
Yay Khae Sat (Yan Kin)	ရေခဲစက် (ရန်ကင်း)
Bo Chan (Lower MinGaLarDone Road)	ဘိုခြံ (အောက်မင်္ဂလာဒုံလမ်း)
Kyaung Gate(Lower MinGaLarDone Road)	ကျောင်းဂိတ် (အောက်မင်္ဂလာဒုံလမ်း)
Saung 2	စောင် ၂
Tha Yat Taw(InnSein)	သရက်တော (အင်းစိန်)
Bo Kone	ဘိုကုန်း
Hite Patt	ဟိုက်ပတ်
Ma Nya Ka	မ ည က
Inn Sein Sayyone(Mingyi Road)	အင်းစိန်ဆေးရုံ (မင်းကြီးလမ်း)
Inn Sein Panchan(Mingyi Road)	အင်းစိန်ပန်းခြံ (မင်းကြီးလမ်း)
Ngar Lane (North OakkaLar)	(၅)လမ်း (မ/ဥက္ကလာ)
A One (BoTayZa Road)	အေဝမ်း (ဗိုလ်တေဇလမ်း)
TaYar-Nhit Gate Haung (BoTayZa Road)	၁၀၂ ဂိတ်ဟောင်း (ဗိုလ်တေဇလမ်း)
Kyang Lane (WaiBarGi)	ကျောင်းလမ်း (ဝေဘာဂီ)
Chauk Kwae(North OakkaLar)	၆ကွေ့ (မြောက်ဥက္ကလာ)
KanTharYar (North OakkaLar)	ကန်သာယာ (မြောက်ဥက္ကလာ)
Yoke Shin Yone(North OakkaLar)	ရုပ်ရှင်ရုံ (မ/ဥက္ကလာ)
Yadana(North OakkaLar)	ရတနာ (မ/ဥက္ကလာ)
Yone Shae(North OakkaLar)	ရုံးရှေ့ (မ/ဥက္ကလာ)
Say Nhint(Oakar)(North OakkaLar)	ဆေး ၂ (ဥက္ကာ) (မ/ဥက္ကလာ)
Yone Thit (North OakkaLar)	ရုံးသစ် (မ/ဥက္ကလာ)
Shit Mile (Junction Eight)	(၈) မိုင် (ဂျန်းရှင်းအိတ်စ်)
Ye Baw Haung (MaYangKone)	ရဲဘော်ဟောင်း (မရမ်းကုန်း)
Nawaday (HlaingThaYar)	နဝဒေး (လှိုင်သာယာ)
Toe Chae (HlaingThaYar)	တိုးချဲ့ (လှိုင်သာယာ)
Panchan (Yangon-Pathein Road)	ပန်းခြံ (ရန်ကုန်-ပုသိမ်လမ်း)
DaGone Aya Ahway PyayWon	ဒဂုံဧရာအဝေးပြေးဝန်း
BaYintNaung LaneSone(ThaMineBuTar Road)	ဘုရင့်နောင်လမ်းဆုံ (သမိုင်းဘူတာလမ်း)
Sae-Khun Zay	၁၇စျေး
Sae-Nhit Zay	၁၂ စျေး
Say Yone Kwae (Shwe Pout Kan)	ဆေးရုံကွေ့ (ရွှေပေါက်ကံ)
Mee Thet(Shwe Pout Kan)	မီးသတ် (ရွှေပေါက်က္ကံ)
Damaryone (North OakkaLar)	ဓမ္မာရုံ (မ/ဥက္ကလာ)
Say Kyaung (KhaYayPin Road)	ဆေးကျောင်း (ခရေပင်လမ်း)
Panchan (KhaYayPin Road)	ပန်းခြံ (ခရေပင်လမ်း)
Chauk Lay Chauk	၆ ၄ ၆
TaNyinKone BuTarZay	တညင်းကုန်းဘူတာစျေး
Sae-Lay LaneSone (ShwePyithar Tatar Road)	၁၄ လမ်းဆုံ (ရွှေပြည်သာတံတားလမ်း)
Pout Tane AhWine	ပေါက်တန်းအဝိုင်း
Tit-Nit-Lay Gate Haung (ShweLinPan)	၁၂၄ ဂိတ်ဟောင်း (ရွှေလင်ပန်း)
Kyaung Shae(AhNawYaHtar-HlaingtharYar)	ကျောင်းရှေ့ (အနော်ရထာ-လှိုင်သာယာ)
Shit-Sae-Chuk GateHaung	၈၆ ဂိတ်ဟောင်း
Aung Mingalar Zay	အောင်မင်္ဂလာစျေး
Thone ThoneLone(PaThein Road)	သုံး သုံးလုံး (ပုသိမ်လမ်း)
Yay Aine(No 2 Road)	ရေအိုင် (အမှတ်(၂)လမ်း)
140	၁၄၀
Myoh Oo Kyaung	မြို့ဦးကျောင်း
Yone Shae (South Dagon)-PyiDaungSu Road	ရုံးရှေ့ (တောင်ဒဂုံ) - ပြည်ထောင်စုလမ်း
Yuzana Awine Htate (Kyun ShweWar Road - Dagon SateKan) Container Gate (Old Name)	ယုဇန အဝိုင်းထိပ် (ကျွန်းရွှေဝါလမ်း - ဒဂုံဆိပ်ကမ်း) ကွန်တိန်နာဂိတ် (နာမည်ဟောင်း)
Gate Haung (Dhamar Yone) Lal Yar	ဂိတ်ဟောင်း (ဓမ္မာရုံ) လယ်ယာ
West Moke Oo (YuZaNa)	အနောက်မုခ်ဦး (ယုဇန)
Shit/Koe Lan Sone (KaNaungMinTharGyi Road)	၈/၉ လမ်းဆုံ (ကနောင်မင်းသားကြီးလမ်း)
Gate Haung (SiiPin Road)	ဂိတ်ဟောင်း (စည်ပင်လမ်း)
Yin Kyay Mhu	ယဉ်ကျေးမှု
Sule (BanDuLa Pan Chan)	ဆူးလေး (ဗန္ဓုလပန်းခြံ)
Bahan Thone Lan	ဗဟန်း (၃) လမ်း
Tamwe Bali	တာမွေဗလီ
SatGone Kwae	စက်ဂုံကွေ့
Sout Loke Yay (ShuKhinThar MyohPat Road)	ဆောက်လုပ်ရေး (ရှုခင်းသာမြို့ပတ်လမ်း)
Kan Gyi Daut	ကန်ကြီးထောင့်
9 Htet Gyi	၉ ထပ်ကြီး
Insein Pan Chan (Baho Road)	အင်းစိန်ပန်းခြံ (ဗဟိုလမ်း)
(3) Lan Sone (No 3 Main Road)	(၃) လမ်းဆုံ (အမှတ် (၃) လမ်းမကြီး)
Aung Mingalar A Way Pyay (Entrance)	အောင်မင်္ဂလာအဝေးပြေး(ဝင်ပေါက်)
Gate Haung (Yadanar Road)	ဂိတ်ဟောင်း (ရတနာလမ်း)
Hledan Kyaung Shae	လှည်းတန်းကျောင်းရှေ့
SaKhan Shae (KaMarYut) NoutPine Ma Yat Par	စခန်းရှေ့ (ကမာရွတ်) နောက်ပိုင်း မရပ်ပါ
Kannar Zay (KanNar Road)	ကမ်းနားစျေး (ကမ်းနားလမ်း)
Nya Zay (KanNar Road)	ညစျေး (ကမ်းနားလမ်း)
Thal Kwin (KanNar Road)	သဲကွင်း (ကမ်းနားလမ်း)
Home Lan (KanNar Road)	ဟုမ်းလမ်း (ကမ်းနားလမ်း)
Thiri Mingalar Zay Haung	သီရိမင်္ဂလာစျေးဟောင်း
Sin Min Zay (KanNar Road)	ဆင်မင်းစျေး (ကမ်းနားလမ်း)
Ahlone Dan O Sat	အလုံဒန်အိုးစက်
ThitTaw (KanNar Road)	သစ်တော (ကမ်းနားလမ်း)
Thakhin Mya Pan Cha (Lower KyiMyintDaing Road)	သခင်မြပန်းခြံ (အောက်ကြည်မြင်တိုင်လမ်း)
Thakhin Mya Pan Cha (AungYadanar Road)	သခင်မြပန်းခြံ (အောင်ရတနာလမ်း)
Ckhnre (KaMarYut)	စခန်းရှေ့ (ကမာရွတ်)
10 Mile - 2 (DU)	၁၀ မိုင် - ၂ (DU)
Yay Khae Sat	ရေခဲစက်
Mya Yadanar (North OakKaLar)	မြရတနာ (မ/ဥက္ကလာ)
Shwe Yin Aye	ရွှေရင်အေး
Sae-Chauk Kwae	၁၆ ကွေ့
Sae-Khun Zay	၁၇ စျေး
B.R.T Gate Haung	ဘီအာတီ ဂိတ်ဟောင်း
Paya Lay Kwae (Yangon - Pyay Road)	ဘုရားလေးကွေ့ (ရန်ကုန်-ပြည်လမ်း)
Htauk Kyant Lan Sone (Yangon - Pyay)	ထောက်ကြန့်လမ်းဆုံ (ရန်ကုန် - ပြည်)
PokePar Kyaung	ပုပ္ပါးကျောင်း
Lan Thit (Htaut Kyant)	လမ်းသစ် (ထောက်ကြန့်)
Kyaung Shae (Htaut Kyant)	ကျောင်းရှေ့ (ထောက်ကြန့်)
Nwe Khwe (Pyay Road)	နွယ်ခွေ (ပြည်လမ်း)
Chan Pauk (PyinMaPin)	ခြံပေါက် (ပျဉ်းမပင်)
Kone Htate	ကုန်းထိပ်
Paya Lay	ဘုရားလေး
Ye Baw Haung (Mingalardon)	ရဲဘော်ဟောင်း (မင်္ဂလာဒုံ)
Bo Chan (Mingalardon)	ဗိုလ်ခြံ (မင်္ဂလာဒုံ)
Bo Yway	ဗိုလ်ရွေး
Yay Kyi Aine (YBS 41,44,91)	ရေကြည်အိုင် (YBS 41,44,91)
War Yar Lat Kyaung Shae	ဝါယာလက်ကျောင်းရှေ့
KyaikKaLoh	ကျိုက်ကလို့
KyaikKaLae	ကျိုက်ကလဲ့
Indaa	ဣန္ဒာ
Waziyar	ဝဇီရာ
Oak Pone Seik (ThuKhiTar Road)	အုတ်ပုံဆိပ် (သုခိတာလမ်း)
435 Tat	၄၃၅ တပ်
436 Tat	၄၃၆ တပ်
Tat Yin (16)	တပ်ရင်း (၁၆)
Shwe Pauk Kan Sin Phone (YBS 19)	ရွှေပေါက်က္ကံဆင်ဖုံ (YBS 19)
Htun Shwe War	ထွန်းရွှေဝါ
War Saing (Shwe Pauk Kan)	ဝါးဆိုင် (ရွှေပေါက်က္ကံ)
11 Zay	၁၁ စျေး
Aung Mingalar (Shwe Pout Kan)	အောင်မင်္ဂလာ (ရွှေပေါက်ကံ)
Aung Myittar (Shwe Pout Kan)	အောင်မေတ္တာ (ရွှေပေါက်ကံ)
103 Gate Haung (Bagan Road)	၁၀၃ ဂိတ်ဟောင်း (ပုဂံလမ်း)
Bayint Naung Lan Sone (BaYintNaung Road)	ဘုရင့်နောင်လမ်းဆုံ (ဘုရင့်နောင်လမ်း)
Thiri Mingalar Zay Thit	သီရိမင်္ဂလာစျေးသစ်
BuTarYone Lan (Bayint Naung)	ဘူတာရုံလမ်း (ဘုရင့်နောင်)
Yay Kyaung Thate Pan	ရေကြောင်းသိပ္ပံ
Thakhin Mya Pan Chan (KanNar Road)	သခင်မြပန်းခြံ (ကမ်းနားလမ်း)
Kyaung Shae (BarKaYar)	ကျောင်းရှေ့ (ဗားကရာ)
A Nout Shwe Gon Tine	အနောက်ရွှေဂုံတိုင်
Lan 30 (KoneThal Road)	လမ်း၃၀ (ကုန်သည်လမ်း)
Sae-ngar Lan/ Nyaung Pin Lay Zay	၁၅လမ်း / ညောင်ပင်လေးစျေး
Maw Tin (KanNar Road)	မော်တင် (ကမ်းနားလမ်း)
Kili (KanNar Road)	ကလီ (ကမ်းနားလမ်း)
Baho Sii	ဗဟိုစည်
Tha Yat Taw (BoGyoke Road)	သရက်တော (ဗိုလ်ချုပ်လမ်း)
West Yangon University	ရန်ကုန်အနောက်ပိုင်းတက္ကသိုလ်
Ah Saung Shae (WYU)	အဆောင်ရှေ့ (WYU)
Tha Yat Chan	သရက်ခြံ
Date Kone	ဒိတ်ကုန်း
Pout Tan	ပေါက်တန်း
DaNyinKone Lan Sone (Lower MinGaLarDone Road)	ဒညင်းကုန်းလမ်းဆုံ (အောက်မင်္ဂလာဒုံလမ်း)
Thamine Lan Sone (Insein Road)	သမိုင်းလမ်းဆုံ (အင်းစိန်လမ်း)
Bartar	ဘာဒါ
Thukha (Insein)	သုခ (အင်းစိန်)
BuTarYone Lan (Insein)	ဘူတာရုံလမ်း (အင်းစိန်)
Hledan (Insein)	လှည်းတန်း (အင်းစိန်)
Saik Pyoe Yay (KaMarYut)	စိုက်ပျိုးရေး (ကမာရွတ်)
HanTharWaddy Awine	ဟံသာဝတီအဝိုင်း
Halpin	ဟယ် (လ်)ပင်
Sein Gyun	စိန့်ဂျွန်း
Say Yone Gyi (Ah Yay Paw)	ဆေးရုံကြီး (အရေးပေါ်)
BoShwal Lan (Maung Khaing)	ဗိုလ်ရွဲလမ်း (မောင်ခိုင်)
124 (ANawYaHtar Road)	၁၂၄ (အနော်ရထာလမ်း)
Gate Haung (AhNawYaHtar - HlaingTharYar)	ဂိတ်ဟောင်း (အနော်ရထာ - လှိုင်သာယာ)
(3) Htate (HlaingTharYar)	(၃) ထိပ် (လှိုင်သာယာ)
Kyaung Shae (RC3)	ကျောင်းရှေ့ (RC3)
Home Lan (Lower KyiMyintDaing Road)	ဟုမ်းလမ်း (အောက်ကြည့်မြင်တိုင်လမ်း)
White Taw (Lower KyiMyintDaing)	ဝှိုက်တော (အောက်ကြည့်မြင်တိုင်)
Sin Min Zay (Lower KyiMyintDaing Road)	ဆင်မင်းစျေး (အောက်ကြည့်မြင်တိုင်လမ်း)
ChaMarBi (Lower KyiMyintDaing Road)	ချမာဘီ (အောက်ကြည့်မြင်တိုင်လမ်း)
ChaMarKhaNar	ဂျမာခနာ
Thakhin Mya Pan Chan (Lower KyiMyintDaing Road)	သခင်မြပန်းခြံ (အောက်ကြည့်မြင်တိုင်လမ်း)
Ywar Pout (WYTU)	ရွာပေါက် (WYTU)
Mya Sein Yaung	မြစိမ်းရောင်
Tat Yin (9) (HlaingTharYar)	တပ်ရင်း (၉) (လှိုင်သာယာ)
TaungNgu	တောင်ငူ
Mawlamyine	မော်လမြိုင်
Gate Haung (North Dagon)	ဂိတ်ဟောင်း (မ/ဒဂုံ)
Bo Min Yaung	ဗိုလ်မင်းရောင်
Sow Myat	စိုးမြတ်
Bo Saw Naung	ဗိုလ်စောနောင်
Ma Wa Ta Sone (PyiDaungSu Road)	မဝတလမ်းဆုံ (ပြည်ထောင်စုလမ်း)
Hnit-sae Shit Ta Dar Htate	၂၈ တံတားထိပ်
Taung Myout Lan Sone (MyohOo Pagoda)	တောင်မြောက်လမ်းဆုံ (မြို့ဦးစေတီ)
Pathein Nhyunt 6 Lan	ပုသိမ်ညွန့် ၆ လမ်း
A.B.C (MingalarTaungNhyunt)	အေဘီစီ (မင်္ဂလာတောင်ညွန့်)
Yone Lay (MingalarTaungNhyunt)	ရုံးလေး (မင်္ဂလာတောင်ညွန့်)
9 Lan	၉ လမ်း
Zay Lan (MinYeKyawSwar Road)	စျေးလမ်း (မင်းရဲကျော်စွာလမ်း)
Gate Haung (MinYeKyawSwar Road)	ဂိတ်ဟောင်း (မင်းရဲကျော်စွာလမ်း)
Shit Tama (MinYeKyawSwar Road)	၈ သမ (မင်းရဲကျော်စွာလမ်း)
Kone Taik (MinYeKyawSwar Road)	ကုန်တိုက် (မင်းရဲကျော်စွာလမ်း)
Thit Sat	သစ်စက်
Kyaung Shae (Dental University)	ကျောင်းရှေ့ (သွားဆေးတက္ကသိုလ်)
Thuwunna Zay (ThanThuMar)	သုဝဏ္ဏစျေး (သံသုမာ)
Thuwunna Lan Sone (ThanThuMar)	သုဝဏ္ဏလမ်းဆုံ (သံသုမာ)
13 Zay (YamoneNar Zay)	၁၃ စျေး (ယမုံနာစျေး)
Say Yone Shae (Myittar Lan)	ဆေးရုံရှေ့ (မေတ္တာလမ်း)
10 Yat Kwet Zay (South OakKaLar)	၁၀ ရပ်ကွက်စျေး (တောင်ဥက္ကလာ)
PaDayThar Lan Sone (Myittar Lan)	ပဒေသာလမ်းဆုံ (မေတ္တာလမ်း)
SisPin Paya Lan	စစ်ပင်ဘုရားလမ်း
Shin Ma Taung	ရှင်မတောင်
Ye Sa Khan (East Dagon)	ရဲစခန်း (ရှေ့ဒဂုံ)
36 Gate Haung	၃၆ ဂိတ်ဟောင်း
KyawKyarr	ကျော်ကြား
Yat Kwet Htate	ရပ်ကွက်ထိပ်
Ma Ya Ka	မ ရ က
Sii Pin Yone	စည်ပင်ရုံး
Insein Say Yone (East Dagon)	အင်းစိန်ဆေးရုံ (ရှေ့ဒဂုံ)
Htan Ta Pin	ထန်းတစ်ပင်
Lan Thit (Min Ye Kyaw Swar)	လမ်းသစ် (မင်းရဲကျော်စွာ)
Meter Yone	မီတာရုံး
37 Gate Haung	၃၇ ဂိတ်ဟောင်း
KuuToh Sate	ကူးတို့ဆိပ်
ZawGyi	ဇော်ဂျီ
SiteShae (MaHarMyaing)	ဆိုက်ရှေ့ (မဟာမြိုင်)
6 Lan (OoWiZaRa Road)	၆ လမ်း (ဦးဝီဇရလမ်း)
Nar Yee Sin (MaHarMyaing)	နာရီစင် (မဟာမြိုင်)
Koke Kine (KaBarAye PaYar Road)	ကုက္ကိုင်း (ကမ္ဘာအေးဘုရားလမ်း)
Shwe Pout Kan Tadar Htate	ရွှေပေါက်ကံတံတားထိပ်
YaZaThinGyan Lan Htate	ရာဇသင်္ကြန်လမ်းထိပ်
8 Thama (MinYeKyawSwar Road)	၈သမ (မင်းရဲကျော်စွာလမ်း)
Gate Haung (Thitsar Lan)	ဂိတ်ဟောင်း (သစ္စာလမ်း)
MyohShaung Lan	မြို့ရှောင်လမ်း
Zay Thit (Bago Road)	စျေးသစ် (ပဲခူးလမ်း)
Htauk Kyant Lan Sone (Yangon - Mandalay)	ထောက်ကြန့်လမ်းဆုံ (ရန်ကုန်-မန္တလေး)
KyaungShae (A Mhat 3 SatThwel Lan)	ကျောင်းရှေ့ (အမှတ်(၃) ဆက်သွယ်လမ်း)
Nwe Khwe (No 3 Main Road)	နွယ်ခွေ (အမှတ်(၃)လမ်းမကြီး)
War Saing (Nwe Khwe)	ဝါးဆိုင် (နွယ်ခွေ)
KokeKoPin (Ma Yat Par)	ကုက္ကိုပင် (မရပ်ပါ)
Tiger Beer Sat Yon	တိုက်ဂါးဘီယာစက်ရုံ
Tat Yin (9) (No 3 Main Road)	တပ်ရင်း (၉) (အမှတ် (၃) လမ်းမကြီး)
Kone Ta La Baung	ကုန်းတလဘောင်
PipeLone (No 3 Main Road) Ma Yat Par	ပိုက်လုံး (အမှတ် (၃) လမ်းမကြီး) မရပ်ပါ
Gate Haung (No 3 Main Road)	ဂိတ်ဟောင်း (အမှတ် (၃) လမ်းမကြီး)
PadaMyar Sine Board	ပတ္တမြားဆိုင်းဘုတ်
Kyaung Shae (No 3 Main Road)	ကျောင်းရှေ့ (အမှတ် (၃) လမ်းမကြီး)
Mhaw Yone	မှော်ရုံ
Palae Lan Sone (Mingalardon)	ပုလဲလမ်းဆုံ (မင်္ဂလာဒုံ)
(6) Lan (No 3 Road) (Ma Yat Par)	(၆) လမ်း (အမှတ်(၃)လမ်း) မရပ်ပါ
Thingangyun Gyi	သင်္ဃန်းကျွန်းကြီး
Nyaung Pin (No 3 Main Road)	ညောင်ပင် (အမှတ် (၃) လမ်းမကြီး)
Thuwanna Stadium	သုဝဏ္ဏဘောလုံးကွင်း
Aung Thukha (Mee Point)	အောင်သုခ (မီးပွိုင့်)
Drkaa Lan Sone	ဒါရ်ကာလမ်းဆုံ
Myoma Lan	မြို့မလမ်း
Myoma Zay (Thanlyin)	မြို့မစျေး (သန်လျင်)
Phoh Myay	ဖို့မြေ
Bago Su	ပဲခူးစု
Say Yone Oaut Kwae	ဆေးရုံအောက်ကွေ့
Say Yone A Paw Kwae	ဆေးရုံအပေါ်ကွေ့
Say Yon Kwae (Thanlyin)	ဆေးရုံကွေ့ (သန်လျင်)
ThaMa University	သမတက္ကသိုလ်
Kyeik Kouk Phayar (ThiLaWar Road)	ကျိုက်ခေါက်ဘုရား (သီလဝါလမ်း)
A Saung Shae (MMU)	အဆောင်ရှေ့ (MMU)
Pal Hlaw Pho (KyaukTan)	ပဲလှော်ဖို (ကျောက်တန်း)
Thein Kone	သိမ်ကုန်း
Motor Seik	မော်တော်ဆိပ်
Saik Pyoe Yay (Thanlyin)	စိုက်ပျိုးရေး (သန်လျင်)
Ta Man Oo Gone Htate	တမံဦးကုန်းထိပ်
PhoneGyiKyaungShae (KyaukTan)	ဘုန်းကြီးကျောင်းရှေ့ (ကျောက်တန်း)
Pal Hlaw Pho (Alal Ywar)	ပဲလှော်ဖို (အလယ်ရွာ)
Gate Haung (KyaukTan)	ဂိတ်ဟောင်း (ကျောက်တန်း)
Gate Thit	ဂိတ်သစ်
Aung Ta Pyay (KyaukTan)	အောင်သပြေ (ကျောက်တန်း)
T U (Thanlyin)	T U (သန်လျင်)
Ah Saung Shae (Thanlyin)	အဆောင်ရှေ့ (သန်လျင်)
Paya Lay (Thanlyin)	ဘုရားလေး (သန်လျင်)
Hta Ma Lone Gone Htate	ထမလုံကုန်းထိပ်
Paya Ngar Suu	ဘုရား (၅)ဆူ
SawBwar Gone Htate	စော်ဘွားကုန်းထိပ်
Sit See Taw	စစ်စီးတော
Nar Yee Sin (Thanlyin)	နာရီစင် (သန်လျင်)
Nant Thar Kone	နံ့သာကုန်း
Ah Nyar Su	အညာစု
Mingalar Zay (SatYone Road)	မင်္ဂလာစျေး (စက်ရုံလမ်း)
A Loke Tha Mar Say Yone	အလုပ်သမားဆေးရုံ
KhaYan Kar Gate	ခရမ်းကားဂိတ်
Nar Yee Sin (KhaYan)	နာရီစင် (ခရမ်း)
Kyo So Yay (KhaYan)	ကြိုဆိုရေး (ခရမ်း)
Kun Moe Dane	ကွမ်းမိုးဒိုန်း
Phoe Nii Lan	ဖိုးနီလမ်း
Day Pauk	ဒေးပေါက်
A Pyo Gyi Tal Su	အပျိုကြီးတဲစု
LatPanTan Paya	လက်ပံတန်းဘုရား
Bagan Taung	ပုဂံတောင်
Pa Dote Gyi	ပဒုတ်ကြီး
Kyaung Su Pa Dote	ကျောင်းစုပဒုတ်
Tha Gyi Pa Dote	သူကြီးပဒုတ်
U Kyar Mhine	ဦးကြာမှိုင်
Mudithar	မုဒိသာ
Lat Pan Kyo	လက်ပန်ကြို
Zwe Thaw Tar Htate	ဇွဲသော်တာထိပ်
Thakhwar Chan	သခွားခြံ
Phayone Lan Khwe	ဖရုံလမ်းခွဲ
ThaKaw Lan Htate	သကောလမ်းထိပ်
Kyo So Yay (Thone Gwa)	ကြိုဆိုရေး (သုံးဂွ)
U Oate Ta Ma	ဦးဥတ္တမ
U Than Chaung	ဦးသံချောင်း
TawKar Gate	တောကားဂိတ်
Koe Lan Sone	(၉) လမ်းဆုံ
LinMaHar	လင်းမဟာ
Mhan Yone	မှန်ရုံ
Khun Htate	(၇)ထိပ်
Mi Thar Su	မိသားစု
ShweEainSi	ရွှေအိမ်စည်
Paya Lay (No 6 Road)	ဘုရားလေး (အမှတ်(၆)လမ်း)
U Tin Hla	ဦးတင်လှ
Nhit Htet Kwae	(၂) ထပ်ကွေ့
Nyaung Ni Tadar Htate	ညောင်နီတံတားထိပ်
Tite Kue Kan	တိုက်ကူးကန်
Pwint Ku	ပွင့်ကူ
ManDarLi Chan	မန်ဒါလီခြံ
TaDar Pyar	တံတားပြာ
Thaung Boh Kan Thal Lan	သောင်ဘို့ကန်သဲလမ်း
Oo Yin Tar Htate	ဥယျာဉ်တာထိပ်
Pyin Ma Kan Thar Htate	ပျဉ်းမကန်သာထိပ်
KanMyint Phone Gyi Kyaung Lan	ကံမြင့်ဘုန်းကြီးကျောင်းလမ်း
KokeKo Nha Pin	ကုက္ကိုလ် ၂ ပင်
Shwe Own Pin	ရွှေအုန်းပင်
Shwe Nyi Ko	ရွှေညီကို
Chin Ma	ချင်းမ
Yat Htar Lan Oak Pauk	ရထားလမ်း Oak Pauk
Nyaung Pin Lay Zay (No 6 Road)	ညောင်ပင်လေးစျေး (အမှတ် (၆) လမ်း)
Motor Seik Oak Pauk	မော်တော်ဆိပ်အုတ်ပေါက်
Chaung Thit	ချောင်းသစ်
NayLaPout (No 6 Road)	နေလပေါက် (အမှတ်(၆)လမ်း)
Chauk Lan Thwar	၆လမ်းသွား
East Yangon University	အရှေ့ပိုင်းရန်ကုန်တက္ကသိုလ်
Nyaung Pin (No 6 Road)	ညောင်ပင် (အမှတ် (၆) လမ်း)
Thone Gate Haung (MyinTawThar)	(၃) ဂိတ်ဟောင်း (မြင်တော်သာ)
YanPyay (YaMoneNar Road)	ရန်ပြေ (ယမုံနာလမ်း)
TheinPhyu (YBS 34)	သိမ်ဖြူ(YBS 34)
Htauk Kyant (YBS 35)	ထောက်ကြန့် (YBS 35)
Kyout Khwel Sat	ကျောက်ခွဲစက်
Khun-hnat Mile	(၇)မိုင်
Chauk Mile Khawe	၆မိုင်ခွဲ
Marlar (Hledan)	မာလာ (လှည်းတန်း)
Tit Nan Pat	တစ်နံပါတ်
Halpin	ဟယ်လ်ပင်
Chauk Htet Yone	၆ ထပ်ရုံး
Sae-Nhit Lone Tan Kwae(Yan Shin Road)	(၁၂) လုံးတန်းကွေ့ (ရန်ရှင်းလမ်း)
War Ta Yar	ဝါးတစ်ရာ
Lay Hlwar	လေးလွှာ
Shin Lin Saung	ရှင်းလင်းဆောင်
Chauk-sae-ngar Gate	၆၅ဂိတ်
Lain Kone	လိန်ကုန်း
Kwat Thit	ကွက်သစ်
Da Dwe	ဒဒွေး
HlawKar Lower Gate	လှော်ကားအောက်ဂိတ်
Thukha (HlawKar)	သုခ (လှော်ကား)
Paya Lay (HlawKar)	ဘုရားလေး (လှော်ကား)
Gate Haung (HlawKar)	ဂိတ်ဟောင်း (လှော်ကား)
Kyaung Shae (HlawKar)	ကျောင်းရှေ့ (လှော်ကား)
HlawKar Tar Sone (Hlaw Kar Road)	လှော်ကားတာဆုံ (လှော်ကားလမ်း)
Pipe Lone (No 4 Road)	ပိုက်လုံး (အမှတ်(၄)လမ်း)
Kyaung Shae (Computer University)	ကျောင်းရှေ့ (ကွန်ပျူတာတက္ကသိုလ်)
ZayYarThiRi	ဇေယျာသီရီ
PoneNya (No 4 Road)	ပုည (အမှတ်(၄)လမ်း)
Than Phyu Sine	သံဖြူဆိုင်
Ye Tat Yin (Chauk)	ရဲတပ်ရင်း (၆)
Gate Haung (No 4 Main Road)	ဂိတ်ဟောင်း (အမှတ်(၄)လမ်းမကြီး)
Sit Tat (Kha La Ya - 6)	စစ်တပ် (ခလရ-၆)
Phone Gyi Kyaung (No 4 Road)	ဘုန်းကြီးကျောင်း (အမှတ်(၄)လမ်း)
Ywarma (Lower MinGaLarDone Road)	ရွာမ (အောက်မင်္ဂလာဒုံလမ်း)
Aye Thein Di	အေးသိဒ္ဓိ
Insein Say Yone (Lower MinGaLarDone Road)	အင်းစိန်ဆေးရုံ (အောက်မင်္ဂလာဒုံလမ်း)
Insein Pan Chan (Lower MinGaLarDone Road)	အင်းစိန်ပန်းခြံ (အောက်မင်္ဂလာဒုံလမ်း)
TU Se Man Kane (MhawBi)	TU စီမံကိန်း (မှော်ဘီ)
Paya Lan Zay	ဘုရားလမ်းစျေး
Mingalar Tite	မင်္ဂလာတိုက်
PawTawMuu	ပေါ်တော်မူ
Shwe Pyi Aye	ရွှေပြည်အေး
Sii Sat (Chan Myae Yeik Thar)	ဆီစက် (ချမ်းမြေ့ရိပ်သာ)
Ah Mhat (Khun)	အမှတ် (၇)
Htan Ta Pin Tar Sone	ထန်းတစ်ပင် တာဆုံ
Electric Yone (MhawBi)	လျှပ်စစ်ရုံး (မှော်ဘီ)
BuTar Kwae (MhawBi)	ဘူတာကွေ့ (မှော်ဘီ)
Ah Mhat (4) Lan Htate (Yangon - Pyay Road)	အမှတ် (၄) လမ်းထိပ် (ရန်ကုန်-ပြည်လမ်း)
Lay Htee (Sae-Chauk)	လေထီး (၁၆)
G.E	ဂျီအီး
Koe-Sae-Tit Gate Gyi	၉၁ ဂိတ်ကြီး
SapThwarTaw Phone Gyi Kyaung	ဆပ်သွားတော ဘုန်းကြီးကျောင်း
Main Ma Line	မိန်း မလိုင်း
Japan Paya (San Chaung Pauk)	ဂျပန်ဘုရား (စမ်းချောင်းပေါက်)
Kyat Phyu Kan Kyaung Shae	ကြက်ဖြူကန် ကျောင်းရှေ့
Ah Thone Lone	အ သုံးလုံး
Say Khan (MhawBi)	ဆေးခန်း (မှော်ဘီ)
(Koe) Lone Kwin Phone Gyi Kyaung	( ၉) လုံးကွင်းဘုန်းကြီးကျောင်း
Mingalar Zay (Yangon - Pyay Road)	မင်္ဂလာစျေး (ရန်ကုန်-ပြည်လမ်း)
Tint Kar	တင့်ကား
Hnit Gate	(၂)ဂိတ်
Sat Ku Sat	စက္ကူစက်
HlawKar Tar Sone (No 4 Road)	လှော်ကား တာဆုံ (အမှတ်(၄)လမ်း)
Moe San	မိုးဆမ်း
Shwe Baho Gate	ရွှေဗဟိုဂိတ်
Eain Mal Gyi	အိမ်မဲကြီး
Aung Myittar (ShwePyiThar)	အောင်မေတ္တာ (ရွှေပြည်သာ)
Na Gyi Zay	ဏ စျေး
Ah Moe Gyi	အမိုးကြီး
Na Gyi Kwae	ဏ ကွေ့
(Thone) Htate (ShwePyiThar)	(၃) ထိပ် (ရွှေပြည်သာ)
Gate Haung (ShwePyiThar)	ဂိတ်ဟောင်း (ရွှေပြည်သာ)
Nawarat Zay	နဝရတ်စျေး
Taw Win	တော်ဝင်
Say Khan (ShwePyiThar)	ဆေးခန်း (ရွှေပြည်သာ)
Yay Sin (ShwePyiThar)	ရေစင် (ရွှေပြည်သာ)
Shwe Pyi Thar Kwae (BoGyokeAungSan Road)	ရွှေပြည်သာကွေ့ (ဗိုလ်ချုပ်အောင်ဆန်းလမ်း)
Kha Yay Pin Lan Sone (KhaYayPin Road)	ခရေပင်လမ်းဆုံ (ခရေပင်လမ်း)
Kha La Ya (Nhit-sae-chauk)	ခလရ (၂၆)
Thuwunna Zay (Kamar Kyi Road)	သုဝဏ္ဏစျေး (ကမာကြည်လမ်း)
Bayint Naung (Kamar Kyi Road)	ဘုရင့်နောင် (ကမာကြည်လမ်း)
Shit/Koe Lan Sone (ShuKhinThar Road)	၈/၉ လမ်းဆုံ (ရှုခင်းသာလမ်း)
YanKin Kalay Say Yone	ရန်ကင်းကလေးဆေးရုံ
Shine Par Gu	သျှင်ပါဂူ
Kyauk Myaung Zay (BaNyar DaLa Road)	ကျောက်မြောင်းစျေး (ဗညားဒလလမ်း)
Botahtaung Paya (Botahtaung Paya Road)	ဗိုလ်တစ်ထောင်ဘုရား (ဗိုလ်တစ်ထောင်ဘုရား လမ်း)
Hlegu Tar Sone (PhaungGyi Road)	လှည်းကူးတာဆုံ (ဖောင်ကြီးလမ်း)
Thin Zar Oo	သဉ္ဇာဦး
Su Paung Yone (Bago Road)	စုပေါင်းရုံး (ပဲခူးလမ်း)
Pan Cherry	ပန်းချယ်ရီ
Ah Mhat (Thone) Lan Sone (Hle Gu)	အမှတ် (၃) လမ်းဆုံ (လှည်းကူး)
Htaut Kyant Zay Thit	ထောက်ကြန့်စျေးသစ်
MinDhama Condo	မင်းဓမ္မကွန်ဒို
Min Kone Zay	မင်းကုန်းစျေး
Saing Bote (PhaungGyi)	ဆိုင်းဘုတ် (ဖောင်ကြီး)
Nyaung Pin (Min Kone)	ညောင်ပင် (မင်းကုန်း)
Thama College Gate Lay	သမကောလိပ်ဂိတ်လေး
Thama College Gate Gyi	သမကောလိပ်ဂိတ်ကြီး
(Nhit) Gate (PhaungGyi)	(၂)ဂိတ် (ဖောင်ကြီး)
SanPya Gone Htate	စံပြဂုံးထိပ်
Ba Thar	ဘသာ
(Sal) Tan Kyaung Shae	(၁၀) တန်းကျောင်းရှေ့
Baho Wun Htan Kyaung	ဗဟို ဝန်ထမ်းကျောင်း
Paya Lay (PhaungGyi)	ဘုရားလေး (ဖောင်ကြီး)
Si Pin Lan Sone (PhaungGyi)	စည်ပင်လမ်းဆုံ (ဖောင်ကြီး)
PayaKone Phone Gyi Kyaung	ဘုရားကုန်းဘုန်းကြီးကျောင်း
PayaKone Sar Thin Kyaung	ဘုရားကုန်းစာသင်ကျောင်း
PayaKone U Thaung Kwae	ဘုရားကုန်းဦးသောင်းကွေ့
Gone Htate Sine Bote	ကုန်းထိပ်ဆိုင်းဘုတ်
Kant Kaw Chan	ကံကော်ခြံ
Oo Yin Wa Mote Hin Khar Pho	ဥယျာဉ်ဝမုန့်ဟင်းခါဖို
Soe Battery	စိုးဘတ္ထရီ
Oo Yin Wa Phone Gyi Kyaung Shae	ဥယျာဉ်ဝဘုန်ကြီးကျောင်းရှေ့
Moe Kaung Paya (PhaungGyi)	မိုးကောင်းဘုရား (ဖောင်ကြီး)
Tha Pyay Taung Paya Lan	သပြေတောင်ဘုရားလမ်း
Thwar Poe Cha	သွားပိုးချ
KyiSoe Tadar	ကြည်စိုးတံတား
Hine Koo Ywar Phyar	ဟိုင်းကူးရွာဖျား
Hine Koo Paya Lan	ဟိုင်းကူးဘုရားလမ်း
Hine Koo Kyaung Shae	ဟိုင်းကူးကျောင်းရှေ့
Hine Koo Aout Su	ဟိုင်းကူးအောက်စု
Kyee Lay Kyee Lan Thit	ကြီးလေးကြီးလမ်းသစ်
Nyaung Kone SaYarGyi PanPal	ညောင်ကုန်းဆရာကြီးပန်းပဲ
Nyaung Kone Nan Ti	ညောင်ကုန်းနံတီ
Nyaung Kone Kyaung Shae	ညောင်ကုန်းကျောင်းရှေ့
Nyaung Kone Tadar	ညောင်ကုန်းတံတား
Ngar SuTaung Ye Kin	၅ ဆုတောင်းရဲကင်း
Ngar SuTaung Lan Sone	၅ ဆုတောင်းလမ်းဆုံ
Sar Bu Taung Mee Yone	စာဗူးတောင်းမီးရုံး
Sar Bu Taung Ywar Phyar	စာဗူးတောင်းရွာဖျား
Sar Bu Taung Gate Gyi	စာဗူးတောင်းဂိတ်ကြီး
Shin Ta Yar	ရှင်တစ်ရာ
Bal Tal Kwae	ဘဲတဲကွေ့
Tha Pate Kone	သပိတ်ကုန်း
Zee Kone	ဇီးကုန်း
Nat Khan Mhway Taik Sat Yone	နှုတ်ခမ်းမွှေးသိုက်စက်ရုံ
MiziMa Gone Yay	မဇ္ဈိမဂုဏ်ရည်
Ka Dit Ywar Phyar	ကဒစ်ရွာဖျား
Ka Dit Lan Thit	ကဒစ်လမ်းသစ်
Aung Myay	အောင်မြေ
Ka Li Htaw Sat Yone	ကလီထော်စက်ရုံ
Ka Li Htaw Ywar	ကလီထော်ရွာ
Htan (Thone) Pin	ထန်း (၃)ပင်
Chaung Kwae	ချောင်းကွေ့
Mhan Kone ThiLaShin Kyaung	မှန်ကုန်းသီလရှင်ကျောင်း
(Lay) Eain Tan	(၄) အိမ်တန်း
SoutLokeYay (Hle Gu)	ဆောက်လုပ်ရေး (လှည်းကူး)
Kyo Kone Paya Kyaung	ကြို့ကုန်းဘုရားကျောင်း
KanNar (Bago River)	ကမ်းနား (ပဲခူးမြစ်)
Kyaung Shae (DarPain)	ကျောင်းရှေ့ (ဒါးပိန်)
Taw Ya	တောရ
Oak Pho Tadar	အုတ်ဖိုတံတား
Oak Kan Gyi	ဥက္ကံကြီး
Phoen Gyo Kyaung Pout (Dat Taw)	ဘုန်းကြီးကျောင်းပေါက် (ဓာတ်တော်)
Myout Pine Lan Sone	မြောက်ပိုင်းလမ်းဆုံ
Ah Lal Pine Lan Sone	အလယ်ပိုင်းလမ်းဆုံ
Paya Gyi Lan Sone	ဘုရားကြီးလမ်းဆုံ
Zay Shae (DarPain)	စျေးရှေ့ (ဒါးပိန်)
Say Yone Lan (DarPain)	ဆေးရုံလမ်း (ဒါးပိန်)
Lan Sone (DarPain)	လမ်းဆုံ (ဒါးပိန်)
Kyauk Tadar (DarPain)	ကျောက်တံတား (ဒါးပိန်)
Ngar Kan Pouk	ငါးကန်ပေါက်
Phone Gyi Kyaung (Pitteaakmiung)	ဘုန်းကြီးကျောင်း (ပိတောက်မြိုင်)
Sal Myaung Gyi	ဆည်မြောင်းကြီး
Ah Mhat (Thone) (DarPain)	အမှတ် (၃) (ဒါးပိန်)
Ah Mhat (Nhit) (DarPain)	အမှတ် (၂) (ဒါးပိန်)
BayDar Lan	ဗေဒါလမ်း
Sal Myaung Lay	ဆည်မြောင်းလေး
Ah Htet Sat	အထက်စက်
Nhit Ywar Kyar Yay Oh Sin	(၂) ရွာကြားရေအိုးစင်
Than Lan Kwae (Lay Htaut Kan)	သံလမ်းကွေ့ (လေးထောင့်ကန်)
Kyaung Lan (Lay Htaut Kan)	ကျောင်းလမ်း (လေးထောင့်ကန်)
Butar (Lay Htaut Kan)	ဘူတာ (လေးထောင့်ကန်)
Sat Yone Shae (Lay Htaut Kan)	စက်ရုံရှေ့ (လေးထောင့်ကန်)
Lay Htaut Kan Site Kwae (No 2 Road)	လေးထောင့်ကန်ဆိုက်ကွေ့ (အမှတ်(၂)လမ်း)
Yeik Thar (No 2 Road)	ရိပ်သာ (အမှတ် (၂) လမ်း)
Tha Ma Sine (Lay Htaut Kan)	သမဆိုင် (လေးထောင့်ကန်)
Mote Pho (No 2 Road)	မုန့်ဖို (အမှတ်(၂) လမ်း)
December Moke Oo	ဒီဇင်ဘာမုခ်ဦး
Sal Myaung (No 2 Road)	ဆည်မြောင်း (အမှတ်(၂) လမ်း)
Thit Taw (No 2 Main Road)	သစ်တော (အမှတ်(၂) လမ်းမကြီး)
Lan Thit (No 2 Main Road)	လမ်းသစ် (အမှတ်(၂) လမ်းမ)
Kyaung Shae (No 2 Road)	ကျောင်းရှေ့ (အမှတ်(၂) လမ်း)
Nyaung 2 Pin	ညောင် (၂)ပင်
Tat Yin Thone (No 2 Main Road)	တပ်ရင်း (၃) (အမှတ် (၂) လမ်းမ)
Nat Sin (No 2 Main Road)	နတ်စင် (အမှတ် (၂) လမ်းမ)
Aung Ka Thaw Ah Lal Pout	အောင်ကသောအလယ်ပေါက်
Ngar-Htake (Sanay Ma)	(၅)ထိပ် (စနေမ)
Mya Sein Aung	မြစိမ်းအောင်
A Loke Tha Mar Say Yone (HlaingTharYar)	အလုပ်သမားဆေးရုံ (လှိုင်သာယာ)
Tuee Chaung (HlaingTharYar)	တူးချောင်း (လှိုင်သာယာ)
Keaak Tadar (Pusim)	ကျောက်တံတား (ပုသိမ်)
Htan Ta Pin Tar Sone (Pathein Road)	ထန်းတစ်ပင် တာဆုံ (ပုသိမ်လမ်း)
Thone Eain Tan	သုံးအိမ်တန်း
Dahma Par La	ဓမ္မပါလ
Kyaung Shae (Htan Ta Pin)	ကျောင်းရှေ့ ( ထန်းတပင်)
Kyaik Kha Nar Ywar Htate	ကျိုက်ခနားရွာထိပ်
Phoe La Zay	ဖိုးလစျေး
Kyat Chan (Htan Ta Pin)	ကြက်ခြံ ( ထန်းတပင်)
Htoo Lay Su	ထူးလေစု
Tar Thit	တာသစ်
Toe Tat	တိုးတက်
Thel Phyu Ywar Htate	သဲဖြူရွာထိပ်
Than Pa Yar Kone	သံပုရာကုန်း
Yoe Khwa	ရိုးခွ
Aye Ywar Lay	အေးရွာလေး
Kyaung Kone Sine Board	ကျောင်းကုန်းဆိုင်းဘုတ်
Nyaung Pin Ngote To	ညောင်ပင်ငုတ်တို
Htan Ta Pin Tar Sone (Htan Ta Pin)	ထန်းတစ်ပင် တာဆုံ (ထန်းတစ်ပင်)
Ah Lal Ywar Gate Yin	အလယ်ရွာ ဂိတ်ရင်း
Ngar-Sae-Thone Gate	၅၃ ဂိတ်
Ah Phyuu Gate	အဖြူဂိတ်
Kyat Chan (ShweLinPan)	ကြက်ခြံ (ရွှေလင်ပန်း)
(Koe-Sae-Chauk) A Pyar Gate	(၉၆) အပြာဂိတ်
Pan Chan (HlaingTharYar)	ပန်းခြံ (လှိုင်သာယာ)
Oan Taw	အုန်းတော
(Sae-Chauk) Kwae (ShweLinBan)	(၁၆) ကွေ့ (ရွှေလင်ဗန်း)
La Thone	လသုံး
PinLone Zay	ပင်လုံစျေး
Chauk Thama	၆ သမ
Ah Lal Ywar (ShweLinPan)	အလယ်ရွာ ရွှေလင်ပန်း
Ah Wine Htate (ShweLinPan)	အဝိုင်းထိပ် (ရွှေလင်ပန်း)
Mu Kyo Lan Sone	မူကြိုလမ်းဆုံ
Sein Pan (HlaingTharYar)	စိန်ပန်း (လှိုင်သာယာ)
Kyaung Shae (KyanSitThar Road-HlaingTharYar)	ကျောင်းရှေ့ (ကျန်စစ်သားလမ်း-လှိုင်သာယာ)
(Sae-Ngar) Zay	(၁၅)စျေး
Tit-nhit-khun Gate Haung	၁၂၇ ဂိတ်ဟောင်း
Kanbawza	ကမ္ဘောဇ
Ta-Ya-Thone Gate Haung (KyanSitThar Road)	၁၀၃ ဂိတ်ဟောင်း (ကျန်စစ်သားလမ်း)
Nyaung Pin (BaYintNaung Road)	ညောင်ပင် (ဘုရင့်နောင်လမ်း)
Padauk Lan (BaYintNaung Road)	ပိတောက်လမ်း (ဘုရင့်နောင်လမ်း)
Bayint Naung Zay	ဘုရင့်နောင်စျေး
Thakhin Mya Pan Chan (Pan Chan Road)	သခင်မြပန်းခြံ (ပန်းခြံလမ်း)
Lan Ngar Sal (BoGyoke Road)	လမ်း ၅ဝ (ဗိုလ်ချုပ်လမ်း)
Maw Tin (MaHarBanDuLa Road)	မော်တင် (မဟာဗန္ဓုလလမ်း)
(Sae-Ngar) Lan (MaHarBanDuLa Road)	(၁၅)လမ်း (မဟာဗန္ဓုလလမ်း)
Chauk Htet Yone	၆ထပ်ရုံး
Chauk Htet Yone (Lan (Thone-Sal))	၆ထပ်ရုံး (လမ်း (၃၀))
(Sae-Ngar) Lan (AhNawYaHtar)	(၁၅)လမ်း (အနော်ရထာ)
Sanpya (ANawYaHtar Road)	စံပြ (အနော်ရထာလမ်း)
Maw Tin (ANawYaHtar Road)	မော်တင် (အနော်ရထာလမ်း)
Yadanar Pone Kwae	ရတနာပုံကွေ့
Zayar Myaing	ဇေယျာမြိုင်
Chauk Lan	၆ လမ်း
Thone Lan (ANawYaHtar Road)	၃လမ်း (အနော်ရထာလမ်း)
Ngar-sae Lay Tha Ma	(၅၄)သမ
NhinSiiKone (Baho Ah Myo ThaMee Say Yone)	နှင်းဆီကုန်း (ဗဟိုအမျိုးသမီးဆေးရုံ)
Yuzana EainYar	ယုဇနအိမ်ယာ
Myathida Pan Chan (Kyun ShweWar Road)	မြသီတာပန်းခြံ (ကျွန်းရွှေဝါလမ်း)
Moke Oo (YuZaNa)	မုခ်ဦး (ယုဇန)
G.E.C	ဂျီ အီး စီ
MaHar BawDi	မဟာဗောဓိ
(Ngar) Htate Sanay Ma	(၅) ထိပ် စနေမ
Thamine Lan Son (BuTarYone Road)	သမိုင်းလမ်းဆုံ (ဘူတာရုံလမ်း)
Kyauk Kone (AungZayYa Road)	ကျောက်ကုန်း (အောင်ဇေယျလမ်း)
Lin Sadaung (ThanHlyatSun)	လင်းစဒေါင်း (သံလျက်စွန်း)
Than Hlyat Sun	သန်လျက်စွန်း
Nwe Thar Kii (Wai Bargi Road - M/U))	နွယ်သာကီ (ဝေဘာဂီလမ်း - မ/ဥ)
Paya Lay Kwae (Wai Bargi Road - M/U)	ဘုရားလေးကွေ့ (ဝေဘာဂီလမ်း - မ/ဥ)
Tit-Nhit-Lay Lan (Mingalar Zay)	၁၂၄ လမ်း (မင်္ဂလာစျေး)
(Sae-Ngar) Zay	(၁၅) စျေး
Hta Naung Yate	ထနောင်ရိပ်
Sin Hnat Kaung Kwae	ဆင်နှစ်ကောင်ကွေ့
Ngar Thone Lone	၅ သုံးလုံး
Nyaung Ywar Zay Htate	ညောင်ရွာစျေးထိပ်
That Yat Pin Chaung	သရက်ပင်ချာင်း
(Ngar) Lan (ThaYatPinChaung)	(၅) လမ်း (သရက်ပင်ချောင်)
(Lay) Lan	(၄) လမ်း
(Thone) Lan	(၃) လမ်း
(Nhit) Lan	(၂) လမ်း
Kyaung Lan Yeik Thar	ကျောင်းလမ်းရိပ်သာ
Nyaung Pin Ywar Htate	ညောင်ပင်ရွာထိပ်
Myanmar Thar Kaung	မြန်မာ့သားကောင်း
Gate Haung (Lay Htaut Kan)	ဂိတ်ဟောင်း (လေးထောင့်ကန်)
Okkan Lan	ဥက္ကံလမ်း
Thit Sat Lan	သစ်စက်လမ်း
Kyaung Shae (Lay Htaut Kan)	ကျောင်းရှေ့ (လေးထောင့်ကန်)
Say Yone Lan	ဆေးရုံလမ်း
Lay Htaut Kan	လေးထောင့်ကန်
Lay Htaut Kan Sike Kwae	လေးထောင့်ကန်ဆိုက်ကွေ့
Thama (Lay Htaut Kan)	သမ (လေးထောင့်ကန်)
Mote Pho (No 2 Road)	မုန့်ဖို (အမှတ် (၂) လမ်း)
Unit Three	ယူနစ်သရီး
Kyo So Yay (No 2 Main Road)	ကြိုဆိုရေး (အမှတ် (၂) လမ်းမကြီး)
Sal Myaung (No 2 Road)	ဆည်မြောင်း (အမှတ် (၂) လမ်း)
Thit Taw (No 2 Main Road)	သစ်တော (အမှတ် (၂) လမ်းမကြီး)
Lan Thit (No 2 Main Road)	လမ်းသစ် (အမှတ် (၂) လမ်းမ)
Kyaung Shae (No 2 Road)	ကျောင်းရှေ့ (အမှတ် (၂) လမ်း)
Ah Kyaw Tae (No 2 Road)	အကြော်တဲ (အမှတ် (၂) လမ်း)
Nyaung Nha Pin	ညောင် (၂) ပင်
Kyauk Lan (No 2 Main Road)	ကျောက်လမ်း (အမှတ် (၂) လမ်းမကြီး)
Tadar Phyu (No 2 Main Road)	တံတားဖြူ (အမှတ် (၂) လမ်းမကြီး)
Tha Yat Pin Chaung	သရက်ပင်ချောင်း
Lal Yar Gate Yin	လယ်ယာဂိတ်ရင်း
Lay-sae-koe Asane Gate Haung (ShuKhinThar MyohPat Road)	၄၉ အစိမ်းဂိတ်ဟောင်း (ရှုခင်းသာမြို့ပတ်လမ်း)
Ngar Kwae	၅ ကွေ့
Tat Tar Haung Yone (SatYone Road)	တံတားဟောင်းရုံး (စက်ရုံလမ်း)
Masalar Set (TaungNyunt)	မဆလာစက် (တောင်ညွန့်)
(Shit-sae-shit) Lan (Daw Thein Tin Road)	(၈၈) လမ်း (ဒေါ်သိန်းတင်လမ်း)
Bu Tar Gyi Kone Htate	ဘူတာကြီးကုန်းထိပ်
Nyaung Pin (No 6 Road)	ညောင်ပင် (အမှတ်(၆)လမ်း)
Sin Phyu Taw	ဆင်ဖြူတော်
Gate Yin	ဂိတ်ရင်း
Bu Tar Yone Lan (Insein Road)	ဘူတာရုံလမ်း (အင်းစိန်လမ်း)
OakKaLarPa Paya (Thitsar Road)	ဥက္ကလာပဘုရား (သစ္စာလမ်း)
Nhit-sal Kone Tike (Hlaw Kar Road)	၂ဝ ကုန်တိုက် (လှော်ကားလမ်း)
Thandar Lan (South Dagon)	သန္တာလမ်း (တောင်ဒဂုံ)
Nhit-sal Kone Tike (Myeik Road)	၂ဝ ကုန်တိုက် (မြိတ်လမ်း)
Chauk Lan (Oo Wi Za Ra Road)	၆လမ်း (ဦးဝီဇရလမ်း)
Zawgyi Kwae	ဇော်ဂျီကွေ့
Bo Min Yaung Eain Yar	ဗိုလ်မင်းရောင်အိမ်ယာ
Bo Htun San	ဗိုလ်ထွန်းစံ
Bo Htun Sein	ဗိုလ်ထွန်းစိန်
La Pyae Wun	လပြည့်ဝန်း
Shit Thama (YarZaDaRitz Road)	၈သမ (ရာဇဓိရာဇ်လမ်း)
Kyaung Lan (YarZaDaRitz Road)	ကျောင်းလမ် (ရာဇဓိရာဇ်လမ်း)
Gate Haung (NgaHtweYue Road)	ဂိတ်ဟောင်း (ငထွေရူးလမ်း)
Zay Lan Sone (No 2 Zay)	စျေးလမ်းဆုံ (အမှတ်(၂)စျေး)
Nga Htwe Yue Lan Htate	ငထွေရူးလမ်းထိပ်
See Sar Yate	ဆည်းဆာရိပ်
Ah Htal Sine	အထည်ဆိုင်
(Shit-sae-lay) Gate Phyar	(၈၄) ဂိတ်ဖျား
E.P.C	အီး ပီ စီ
Ah Loke Thamar Lan	အလုပ်သမားလမ်း
Nyaung Pin (HlaingTharYar)	ညောင်ပင် (လှိုင်သာယာ)
Kyaung Shae (FMI City)	ကျောင်းရှေ့ (FMI City)
Ah Lo Taw Pyae (Yadanar Road)	အလိုတော်ပြည့် (ရတနာလမ်း)
Zay Pout	စျေးပေါက်
Sa Khan Shae (AhNawYaHtar-HlaingtharYar)	စခန်းရှေ့ (အနော်ရထာ-လှိုင်သာယာ)
Mhwe	မွှေး
Tole Gate Haung	တိုး(လ်)ဂိတ်ဟောင်း
Ah Wine (DU)	အဝိုင်း (DU )
Koe-sae-koe (Chauk/Thone)	99 (6/3)
Da Nyin Kone Lan Sone (Lower Mingalardon) Lan	ဒညင်းကုန်းလမ်းဆုံ (အောက်မင်္ဂလာဒုံ)လမ်း
Nhit-ThoneNya-Ngar Kwae	၂၀၅ကွေ့
Pan Pin Gyi Lan (Salin Kwin)	ပန်းပင်ကြီးလမ်း (စလင်းကွင်း)
Tike Gyi Gate	တိုက်ကြီးဂိတ်
Min Kyaung	မင်းကျောင်း
PhaungGyi Lan Khwe	ဖောင်ကြီး လမ်းခွဲ
Sel Myaung (Tike Gyi)	ဆည်မြောင်း (တိုက်ကြီး)
Yay Ta Gar	ရေတံခါး
Tar Gwa Phone Gyi Kyaung	တာဂွဘုန်းကြီးကျောင်း
Shwe Bhone Thar	ရွှေဘုံသာ
Tike Gyi Tar Gwa Tar Sone	တိုက်ကြီး တာဂွတာဆုံ
Kan Kone (Tha Yat Chan)	ကံကုန်း (သရက်ခြံ)
Kha Yay Pin	ခရေပင်
Shwe Mya Yar Tar Sone	ရွှေမြယာ တာဆုံ
Tat Yin (Thone) (Okkan)	တပ်ရင်း (၃) (ဥက္ကံ )
Ngar Pyaw Chan	ဌက်ပျောခြံ
Myaung Takar Yay Kyaw	မြောင်းတကာ ရေကျော်
Sein Ka Lar	စိန်ကုလား
Myaung Takar Tar Sone	မြောင်းတကာ တာဆုံ
Myaung Ta Kar Kywe Lan	မြောင်းတကာ ကျွဲလမ်း
Aye Chan	အေးချမ်း
Myaung Ta Kar Pha Ye Khinn	မြောင်းတကာ ဖရဲခင်း
Sat Mhu Zone Lan Thit	စက်မှုဇုံလမ်းသစ်
Say War Kone Kyan	ဆေးဝါးကုန်ကြမ်း
Tat Ma Taw (Ballone Sat)	တပ်မတော် (ဘောလုံးစက်)
Myo Chaung Tar Sone	မြို့ချောင်းတာဆုံ
Auk Shine	အောက်ရှိုင်း
Saik Pyoe Yay (MhawBi)	စိုက်ပျိုးရေး (မှော်ဘီ)
Koe Lone Kwin	ကိုးလုံးကွင်း
(Shit-sae-nhit) Gate Gyi	(၈၂) ဂိတ်ကြီး
Koe Gate	(၉)ဂိတ်
Taik Kyi Electric Yone	တိုက်ကြီး လျှပ်စစ်ရုံး
La Pyae Kone	လပြည့်ကုန်း
Myay Sar Yin ThinTan Kyaung	မြေစာရင်းသင်တန်းကျောင်း
Shwe Mya Yar Ywar Phyar	ရွှေမြယာရွာဖျား
Pyoe Oo Yin	ပျိုးဥယျာဉ်
Phouk Sat	ဖောက်စက်
Htauk Kyant Lan Sone (Yangon - Pyay)	ထောက်ကြန့်လမ်းဆုံ (ရန်ကုန်-ပြည်)
(Chauk) Lan (No 3 Road) Ma Yat Par	(၆) လမ်း (အမှတ် (၃) လမ်း) မရပ်ပါ
Nwe Khwe (No 3 Main Road)	နွယ်ခွေ (အမှတ် (၃) လမ်းမကြီး)
Kyaung Shae (No 3 Sat Thwel Road)	ကျောင်းရှေ့ (အမှတ် (၃) ဆက်သွယ်လမ်း)
Htauk Kyant Lan Sone (Yangon-Mandalay)	ထောက်ကြန့်လမ်းဆုံ (ရန်ကုန်–မန္တလေး)
Kye Su (AungMyintMo)	ကျီစု (အောင်မြင့်မိုရ်)
Tit-ThoneNya-Ngar Zay	၁၀၅ စျေး
Tayar-Chouk Lan Sone	( ၁၀၆) လမ်းဆုံ
Ngu War	ငုဝါ
(Tayar-Khun) Gate Haung	(၁၀၇) ဂိတ်ဟောင်း
Khun-sal/Khun-tit Zay (Hlaw Kar Road)	၇၀/၇၁ စျေး (လှော်ကားလမ်း)
Ngar-sae-Lay Tadar Htate	၅၄ တံတားထိပ်
Nha-Sal Kone Taik	၂ဝ ကုန်တိုက်
Taung Myout Lan Sone (PyiDaungSu Road)	တောင်မြောက်လမ်းဆုံ (ပြည်ထောင်စု လမ်း)
Gate Haung (South OakKaLar)	ဂိတ်ဟောင်း (တောင်ဥက္ကလာ)
DaGone Aya Ahway PyayWon	ဒဂုံဧရာ အဝေးပြေးဝန်း
Thone Htate (HlaingMyit Road)	၃ ထိပ် (လှိုင်မြစ်လမ်း)
Thone-sae-tit Gate Haung (South OakKaLar)	(၃၁)ဂိတ်ဟောင်း (တောင်ဥက္ကလာ)
Nyaung Pin (Hlaw Kar Road)	ညောင်ပင်(လှော်ကားလမ်း)
Piitti (Hlaw Kar Road)	ပီတိ(လှော်ကားလမ်း)
Thone Thone Lone (Yangon - Pyay)	သုံး သုံးလုံး (ရန်ကုန် - ပြည်)
Kyaung Shae (Paya Lan)	ကျောင်းရှေ့ (ဘုရားလမ်း)
Ah Thaw Ka (MhawBi)	အသောက (မှော်ဘီ)
Khun-hnat Mile	(7)မိုင်
Hle Gu (Pyi Taw Thar)	လှည်းကူး (ပြည်တော်သာ)
Mee Thet (Bago Road)	မီးသတ် (ပဲခူးလမ်း)
YanKin Ngar Lan (Bago Road)	ရန်ကင်း ၅ လမ်း (ပဲခူးလမ်း)
Ah Mhat Thone Lan Sone (Bago Road)	အမှတ် ၃ လမ်းဆုံ (ပဲခူးလမ်း)
Auk Gate (Bago Road)	အောက်ဂိတ် (ပဲခူးလမ်း)
Khun-hnat Mile	( ၇) မိုင်
Gate Haung (No 4 Main Road)	ဂိတ်ဟောင်း (အမှတ် (၄) လမ်းမကြီး)
HlawKar Tar Sone	လှော်ကားတာဆုံ
Taw Ywar Lay	တောရွာလေး
Taw Ywar Gyi	တောရွာကြီး
Thel Kone Ywar	သဲကုန်းရွာ
Thar Yar Kone	သာယာကုန်း
Kin Ma Lin	ကင်မလင်း
Thal Phyu	သဲဖြူ
Yay Kyaw	ရေကျော်
Phan Khar Kone	ဖန်ခါးကုန်း
Nyaung Ywar	ညောင်ရွာ
Kyauk Kone Ywar	ကျောက်ကုန်းရွာ
(Lay) Lan Htate	( ၄) လမ်းထိပ်
No (4) Lan Sone	အမှတ် (၄)လမ်းဆုံ
Ah Nout Kyaung Gyi	အနောက်ကျောင်းကြီး
Ngar Lan (Yuzana)	( ၅) လမ်း (ယုဇန)
Kye Su (Min Ye Kaung Pone Road)	ကျီစု (မင်းရဲကောင်းပုံလမ်း)
Tayar-Ngar Zay Lan Sone	၁၀၅ စျေးလမ်းဆုံ
Kyaung Shae (Hlaw Kar Road)	ကျောင်းရှေ့ (လှော်ကားလမ်း)
Yone Lan	ရုံးလမ်း
Aung Myint Mo Eain Yar	အောင်မြင့်မိုရ်အိမ်ရာ
Lan Sone (HlawKar YoMa Yeik Thar)	လမ်းဆုံ (လှော်ကားရိုးမရိပ်သာ)
Lay-Sal Gate Haung	၄၀ ဂိတ်ဟောင်း
Htauk Kyant (Gate Yin)	ထောက်ကြန့် (ဂိတ်ရင်း)
Tayar-Chauk Tat Yin	( ၁၀၆) တပ်ရင်း
Thakhin Mya Pan Chan (Lower KyiMyintDaing Road)	သခင်မြပန်းခြံ (အောက်ကြည်မြင်တိုင် လမ်း)
Bu Tar Gyi	ဘူတာကြီး
Aung San Kwin (Upper PanSoeDan Road)	အောင်ဆန်းကွင်း (အထက်ပန်းဆိုးတန်း လမ်း)
Bu Tar Gyi Win	ဘူတာကြီးဝန်း
Ah Phyuk	အဖျောက်
Ah Phyuk Tar Sone	အဖျောက်တာဆုံ
SaKar Gyi	ဆကာကြီး
Taw La Ti	တော်လတီ
Yay Paw Thaung Tadar	ရေပေါ်သောင်တံတား
Kyuu Taw	ကျူတော
Moke Wa (WYU)	မုဒ်ဝ (WYU)
Kyauk Taw Gyee (Mindahma Road)	ကျောက်တော်ကြီး (မင်းဓမ္မလမ်း)
Yone Shae (DU)	ရုံးရှေ့ ( DU)
Moke Oo (DU)	မုခ်ဦး (DU )
Gate Haung (YarZaDaRitz Road)	ဂိတ်ဟောင်း (ရာဇဓိရာဇ်လမ်း)
Zay Lan (YarZaDaRitz Road)	စျေးလမ်း (ရာဇဓိရာဇ်လမ်း)
Yone Shae (DU)	ရုံးရှေ့(DU)
Paya (Ngar) Suu	ဘုရား (၅) ဆူ
Sae-Shit Kone Htaik	( ၁၈) ကုန်းထိပ်
Pan Chan (KyaukTan)	ပန်းခြံ (ကျောက်တန်း)
Myoma Zay (KyaukTan)	မြို့မစျေး (ကျောက်တန်း)
(Nha-sae-thone) Gate	(၂၃) ဂိတ်
Pha Htee	ဖထီး
Sae-Nhit Lone Tan Kwae(Yan Shin Road)	( ၁၂)လုံးတန်းကွေ့ (ရန်ရှင်းလမ်း)
Sae-tit Lan (PoneNarMe)	၁၁ လမ်း (ပုဏ္ဏမီ)
Padauk Kwae (PoneNarMe Road)	ပိတောက်ကွေ့ (ပုဏ္ဏမီလမ်း)
Oh Eain (PoneNarMe Road-Dagon SateKan)	အိုးအိမ် (ပုဏ္ဏမီလမ်း - ဒဂုံဆိပ်ကမ်း)
Lay-sae-koe Gate Haung (Yadanar Road) TineYinThar Village	(၄၉) ဂိတ်ဟောင်း (ရတနာလမ်း) တိုင်းရင်းသား ကျေးရွာ
Thein Kyaung Lan Sone (Bago River Road)	သိမ်ချောင်းလမ်းဆုံ (ပဲခူးမြစ်လမ်း)
Ngar-sae-khun Lay Har Pyin Zay	57 လေဟာပြင်စျေး
Yay Khal Sine (NatMout Road)	ရေခဲဆိုင် (နတ်မောက်လမ်း)
Watt Su (ThuMaNa Road)	ဝက်စု (သုမနလမ်း)
Thone Sae Ngar Kwae	၃၅ ကွေ့
Myanmar Sar	မြန်မာစာ
46	46
Ngar Sal Kwae (YarZaThinGyan)	၅၀ ကွေ့ (ရာဇသင်္ကြန်)
Ngar Sal Zay	၅၀ စျေး
Chauk-sae-Tit	၆၁
GaYuNar Kwae	ဂရုဏကွေ့
Myittar Kwae	မေတ္တာကွေ့
Gate Haung (Thu Nandar)	ဂိတ်ဟောင်း (သုနန္ဒာ)
Sabal Phyu	စံပါယ်ဖြူ
Sae-Hnit Thama	(၁၂)သမ
Shwe Pyi Thar Lain Kone	ရွှေပြည်သာလိန်ကုန်း
Shit-sae-tit Gate Haung	၈၁ ဂိတ်ဟောင်း
Pale Lan Sone (ShwePyiThar)	ပုလဲလမ်းဆုံ (ရွှေပြည်သာ)
Ta Par Kwae	တစ်ပါကွေ့
Sae-Lay Lan Sone (Pale Road)	၁၄ လမ်းဆုံ (ပုလဲလမ်း)
Pyi Taw Thar (Ywarma)	ပြည်တော်သာ (ရွာမ)
Ywarma (BaYintNaung Road)	ရွာမ (ဘုရင့်နောင်လမ်း)
Kaw Htike Sat Yone	ကောထိုက်စက်ရုံ
Sae-Koe Lan Sone	၁၉ လမ်းဆုံ
Than Dinn (ShwePyiThar)	သံဒင်း (ရွှေပြည်သာ)
Shwe Gu MoeGote	ရွှေဂူမိုးကုတ်
Kyaung Shae (Than Din)	ကျောင်းရှေ့ (သံဒင်)
Than Din Zay	သံဒင်းစျေး
Ngwe Pale	ငွေပုလဲ
KaBar Lone	ကမ္ဘာလုံး
Than Dinn Mg	သံဒင်းမောင်
Thiri Mingalar Pat Lan	သီရိမင်္ဂလာပတ်လမ်း
Yuzana Eain Yar (Pan Chan)	ယုဇနအိမ်ယာ (ပန်းခြံ)
Ye Tat Yin	ရဲတပ်ရင်း
Ye Ah Kyat Ah Tat ThinTan Kyaung (Gate Yin)	ရဲအကြပ်အတတ်သင်ကျောင်း (ဂိတ်ရင်း)
Na Gyi Kwae	ဏကွေ့
YamaNya Saung	ရာမညဆောင်
Thone Thone Lone (No 3 Main Road)	သုံးသုံးလုံး (အမှတ် (၃) လမ်းမကြီး)